{
	"name": "orbital",
	"par": 49,
	"start": [ 1, 6 ],
	"grid": [
		[  0,  0,  0,  0,  0,  0,  0,  2,  2,  0,  0,  0,  0 ],
		[  0,  0,  0,  0,  0,  0,  2,  1,  2,  0,  0,  2,  2 ],
		[  0,  0,  2,  2,  0,  0,  2,  2,  0,  0,  2,  1,  2 ],
		[  0,  2,  0,  2,  2,  2,  2,  2,  2,  2,  2,  2,  0 ],
		[  0,  2,  0,  2,  2,  2,  0,  2,  2,  0,  0,  0,  0 ],
		[  0,  2,  0,  2,  1,  2,  0,  2,  2,  0,  0,  0,  0 ],
		[  0,  1,  0,  2,  2,  0,  2,  1,  2,  0,  0,  0,  0 ],
		[  2,  2,  2,  0,  0,  0,  2,  2,  0,  0,  0,  0,  0 ],
		[  2,  2,  2,  0,  0,  0,  0,  0,  0,  0,  0,  0,  0 ],
		[  2,  2,  0,  0,  0,  0,  0,  0,  0,  0,  0,  0,  0 ]
	]
}