{
	"name": "hive",
	"par": 24,
	"start": [ 0, 4 ],
	"grid": [
		[  0,  0,  0,  1,  2,  2,  0,  0 ],
		[  0,  0,  2,  2,  0,  2,  2,  1 ],
		[  0,  2,  0,  2,  2,  0,  2,  0 ],
		[  0,  2,  2,  0,  2,  2,  0,  0 ],
		[  2,  0,  2,  2,  0,  2,  0,  0 ],
		[  2,  2,  0,  2,  2,  0,  0,  0 ],
		[  0,  2,  2,  1,  0,  0,  0,  0 ]
	]
}