{
	"name": "there_and_back",
	"par": 32,
	"start": [ 0, 6 ],
	"grid": [
		[  0,  0,  0,  0,  2,  2,  2,  2,  2 ],
		[  0,  0,  0,  1,  0,  1,  0,  0,  1 ],
		[  0,  0,  0,  2,  2,  2,  2,  2,  0 ],
		[  0,  0,  1,  0,  0,  1,  0,  1,  0 ],
		[  0,  0,  2,  2,  2,  2,  2,  0,  0 ],
		[  0,  0,  0,  1,  0,  0,  1,  0,  0 ],
		[  1,  2,  2,  2,  2,  2,  0,  0,  0 ],
		[  0,  0,  0,  0,  0,  2,  1,  0,  0 ],
		[  0,  0,  0,  0,  1,  1,  0,  0,  0 ]
	]
}