{
	"name": "mini_island",
	"par": 34,
	"start": [ 0, 4 ],
	"grid": [
		[  0,  0,  0,  0,  0,  0,  0,  2,  0,  0,  0 ],
		[  0,  0,  0,  2,  2,  2,  0,  2,  2,  2,  0 ],
		[  0,  0,  2,  0,  0,  0,  2,  4,  0,  2,  2 ],
		[  0,  2,  2,  0,  2,  4,  0,  2,  0,  2,  0 ],
		[  1,  2,  4,  0,  1,  4,  0,  2,  0,  2,  0 ],
		[  0,  0,  2,  0,  2,  0,  0,  4,  0,  2,  0 ],
		[  0,  0,  2,  2,  0,  2,  2,  2,  0,  2,  2 ],
		[  0,  0,  0,  0,  2,  0,  0,  2,  2,  0,  0 ]
	]
}