{
	"name": "archipelago",
	"par": 33,
	"start": [ 1, 6 ],
	"grid": [
		[  0,  0,  0,  0,  0,  0,  0,  0,  0,  0,  4,  1,  0 ],
		[  0,  0,  0,  0,  0,  0,  0,  0,  0,  1,  1,  4,  0 ],
		[  0,  0,  0,  0,  0,  0,  0,  0,  0,  4,  1,  0,  0 ],
		[  0,  0,  0,  0,  0,  2,  2,  0,  0,  0,  0,  2,  2 ],
		[  0,  0,  0,  0,  4,  2,  2,  0,  4,  2,  4,  2,  2 ],
		[  0,  1,  1,  0,  2,  2,  0,  2,  2,  4,  2,  2,  0 ],
		[  1,  1,  1,  0,  0,  0,  0,  2,  2,  0,  0,  0,  0 ],
		[  1,  4,  0,  2,  2,  0,  0,  0,  0,  0,  0,  0,  0 ],
		[  0,  0,  2,  2,  4,  0,  2,  4,  0,  0,  0,  0,  0 ],
		[  0,  0,  2,  4,  0,  2,  2,  2,  0,  0,  0,  0,  0 ],
		[  0,  0,  0,  0,  0,  2,  2,  0,  0,  0,  0,  0,  0 ]
	]
}