{
	"name": "trampolines",
	"par": 26,
	"start": [ 6, 2 ],
	"grid": [
		[  0,  0,  0,  0,  0,  0,  0,  0,  0,  0,  1 ],
		[  0,  0,  0,  0,  0,  0,  0,  0,  1,  1,  0 ],
		[  0,  0,  0,  0,  0,  0,  1,  1,  4,  1,  6 ],
		[  0,  0,  0,  0,  0,  0,  0,  1,  0,  0,  0 ],
		[  0,  0,  0,  2,  0,  0,  6,  0,  2,  1,  2 ],
		[  6,  4,  2,  4,  0,  0,  0,  0,  2,  0,  2 ],
		[  1,  4,  0,  0,  0,  0,  0,  0,  2,  2,  2 ],
		[  1,  0,  4,  0,  4,  2,  2,  0,  2,  0,  0 ],
		[  0,  2,  0,  4,  0,  4,  2,  4,  0,  4,  1 ],
		[  0,  4,  0,  0,  0,  0,  0,  1,  1,  1,  0 ],
		[  0,  0,  0,  0,  4,  1,  1,  0,  0,  0,  0 ],
		[  0,  4,  0,  0,  0,  0,  0,  0,  0,  0,  0 ],
		[  0,  0,  4,  0,  0,  0,  0,  0,  0,  0,  0 ],
		[  4,  2,  0,  0,  0,  0,  0,  0,  0,  0,  0 ]
	]
}