{
	"name": "transport_hub",
	"par": 38,
	"start": [ 5, 5 ],
	"grid": [
		[  0,  0,  0,  0,  0,  0,  0,  0,  0,  7,  0 ],
		[  0,  0,  0,  0,  2,  0,  0,  0,  0,  7,  8 ],
		[  0,  0,  0,  0,  0,  0,  0,  0,  0,  0,  7 ],
		[  2,  2,  0,  0,  0,  0,  0,  0,  0,  0,  0 ],
		[  2,  2,  0,  0,  0,  0,  0,  2,  2,  2,  0 ],
		[  2,  0,  0,  0, 14,  1, 14,  0,  0,  2,  0 ],
		[  2,  0,  0,  0, 14,  0, 14,  0,  0,  2,  0 ],
		[  2,  2,  0,  0,  0,  0,  0,  0,  0,  2,  0 ],
		[  2,  2, 14,  0,  0,  0,  0,  0,  0,  0,  2 ],
		[  2,  2,  2,  0,  0,  0,  0,  0,  0,  0,  2 ],
		[  0,  0,  0,  0,  0,  0,  2,  0,  0,  0,  0 ]
	]
}