{
	"name": "rental_boat",
	"par": 33,
	"start": [ 2, 6 ],
	"grid": [
		[  0,  0,  0,  0,  0,  0,  0,  0,  3,  3 ],
		[  0,  0,  0,  0,  0,  0,  0,  0,  3,  3 ],
		[  0,  0,  0,  0,  0,  0,  0,  0,  0,  0 ],
		[  0,  0,  0,  0,  0,  0, 12,  0,  0,  0 ],
		[  0,  0,  0,  0,  0,  0,  0,  0,  0,  0 ],
		[  0,  0,  0,  1, 12,  0,  0,  0,  0,  0 ],
		[  0,  0,  1,  1,  0, 14,  0,  1,  0,  0 ],
		[  0,  0,  0,  2,  2,  1,  1, 12,  0,  0 ],
		[  0,  0,  0,  2,  2,  0,  1,  1,  0,  0 ],
		[  0,  0,  0,  0,  0,  0,  0,  0,  0,  0 ],
		[  0,  1,  1,  0,  0,  0,  0,  0,  0,  0 ],
		[  1,  1,  0,  0,  0,  0,  0,  0,  0,  0 ]
	]
}