{
	"name": "ferrying",
	"par": 33,
	"start": [ 0, 11 ],
	"grid": [
		[  0,  0,  0,  0,  1,  2,  2,  0,  2,  2 ],
		[  0,  0,  0,  1,  1,  0,  2,  2,  4,  2 ],
		[  0,  0,  0,  2,  0,  2,  4,  2,  2, 14 ],
		[  0,  0,  0,  2,  0,  2,  2,  0,  0,  0 ],
		[  0,  0,  0, 14,  0,  0,  2,  0,  0,  0 ],
		[  0,  0,  0,  0,  0,  0,  0,  0,  0,  0 ],
		[  0,  0,  0,  0,  0,  0, 14,  0,  0,  0 ],
		[  0,  0,  0,  0,  0,  0,  2,  0,  0,  0 ],
		[  0,  0,  0,  0,  0,  2,  0,  2,  0,  0 ],
		[  0,  0,  0,  2,  1,  1,  2,  0,  0,  0 ],
		[  0,  1,  2,  2,  0,  0,  2,  0,  0,  0 ],
		[  1,  1,  0,  0,  0,  0,  0,  0,  0,  0 ]
	]
}