{
	"name": "lifts",
	"par": 92,
	"start": [ 1, 9 ],
	"grid": [
		[  0,  0,  0,  3,  3,  8,  0,  0,  0,  0,  0 ],
		[  0,  0,  0,  0,  8,  0,  0,  0,  0,  0,  0 ],
		[  0,  0,  0,  0,  4,  0,  0,  0,  0,  0,  0 ],
		[  0,  0,  0,  8,  8,  3,  0,  0,  0,  0,  0 ],
		[  0,  3,  3,  8,  8,  0,  3,  0,  0,  0,  0 ],
		[  0,  0,  0,  0,  0,  0,  3,  0,  0,  0,  0 ],
		[  0,  5, 15,  0,  0,  0, 15, 15,  0,  0,  0 ],
		[ 15,  0,  0,  0,  0,  0,  2,  0,  4,  2,  0 ],
		[  0,  4,  0,  0,  0,  0,  2,  2,  2,  0,  8 ],
		[  0,  1,  0,  0,  0,  0,  0,  0,  0,  3,  8 ],
		[  1,  1,  1,  0,  0,  0,  0,  0,  7,  7,  7 ]
	]
}