{
	"name": "lifts",
	"par": 92,
	"start": [ 1, 11 ],
	"grid": [
		[  0,  0,  0,  0,  3,  8,  0,  0,  0,  0,  0 ],
		[  0,  0,  0,  3,  8,  0,  0,  0,  0,  0,  0 ],
		[  0,  0,  0,  0,  4,  0,  0,  0,  0,  0,  0 ],
		[  0,  0,  0,  0,  8,  3,  3,  0,  0,  0,  0 ],
		[  0,  0,  0,  8,  8,  0,  3,  0,  0,  0,  0 ],
		[  0,  0,  3,  8,  0,  0, 15, 15,  4,  2,  8 ],
		[  0,  3,  0,  0,  0,  0,  2,  0,  2,  0,  8 ],
		[  0,  0, 15,  0,  0,  0,  2,  2,  0,  3,  7 ],
		[  0,  5,  0,  0,  0,  0,  0,  0,  7,  7,  0 ],
		[ 15,  0,  0,  0,  0,  0,  0,  0,  0,  0,  0 ],
		[  0,  4,  0,  0,  0,  0,  0,  0,  0,  0,  0 ],
		[  0,  1,  1,  0,  0,  0,  0,  0,  0,  0,  0 ],
		[  1,  1,  0,  0,  0,  0,  0,  0,  0,  0,  0 ]
	]
}