{
	"name": "trampoline_retrieval",
	"par": 85,
	"start": [ 7, 3 ],
	"grid": [
		[  0,  0,  0,  0,  0,  0,  0,  0,  0,  2,  2,  2 ],
		[  0,  0,  0,  0,  0,  0,  0,  0,  0,  2,  2,  2 ],
		[  0,  0,  0,  3,  3,  3,  0,  0,  0,  0,  2,  2 ],
		[  0,  0,  0,  3,  3,  3,  3,  1, 14,  2,  2,  2 ],
		[  0,  0,  0, 16, 16, 16,  0,  1,  0,  0,  2,  0 ],
		[  0, 16, 16,  0,  0,  0, 14,  0,  1,  0,  0,  0 ],
		[ 16,  4,  4,  0,  5,  0,  0,  0,  1,  0,  0,  0 ],
		[ 16,  0,  5,  0,  0,  8,  0,  1,  1,  0,  2,  2 ],
		[ 16, 16,  0, 16,  8, 15,  0,  3,  0,  2,  2,  2 ],
		[  0,  0, 16,  0,  7,  7,  3,  0,  0,  2,  2,  0 ]
	]
}