{
	"par": 79,
	"start": [ 0, 9 ],
	"grid": [
		[  0,  0,  0,  2,  2,  2,  0 ],
		[  0,  2,  2,  0,  0,  0,  2 ],
		[  0,  0,  0,  0,  0,  0, 14 ],
		[  2,  7,  0,  0,  0,  0,  0 ],
		[  0,  7,  0,  0,  0,  0,  0 ],
		[  0,  7,  0,  0,  0,  0,  0 ],
		[  0,  0,  0,  0,  0,  0,  0 ],
		[  0,  5,  7,  2,  0,  0,  0 ],
		[  5,  0,  7,  2,  2,  2,  2 ],
		[  2,  0,  0,  2,  2,  0,  0 ]
	]
}