{
	"name": "rolling_hexagons",
	"par": 79,
	"start": [ 0, 11 ],
	"grid": [
		[  0,  0,  0,  0,  2,  2,  2 ],
		[  0,  0,  0,  2,  0,  0, 14 ],
		[  0,  0,  2,  0,  0,  0,  0 ],
		[  0,  2,  0,  0,  0,  0,  0 ],
		[  0,  0,  0,  0,  0,  0,  0 ],
		[  2,  7,  0,  0,  0,  0,  0 ],
		[  0,  7,  0,  0,  0,  0,  0 ],
		[  0,  7,  0,  0,  0,  0,  2 ],
		[  0,  0,  7,  2,  2,  2,  0 ],
		[  0,  5,  7,  2,  2,  0,  0 ],
		[  5,  0,  0,  2,  0,  0,  0 ],
		[  2,  0,  0,  0,  0,  0,  0 ]
	]
}