{
	"name": "telephone",
	"par": 59,
	"start": [ 6, 3 ],
	"grid": [
		[  0,  0,  0,  0,  2,  2,  2,  2,  2,  0,  0 ],
		[  0,  0,  0,  2, 15,  2,  2,  2,  2,  0,  0 ],
		[  0,  0,  2,  2,  4,  2,  0,  2,  0,  0,  0 ],
		[  0,  2,  2,  2,  2,  2,  7,  0,  0,  0,  0 ],
		[  2,  2,  0,  2,  8,  8,  2,  0,  0,  7,  7 ],
		[  2,  2,  7,  8,  3,  8,  2,  7,  7,  0,  0 ],
		[  0,  0,  2,  8,  8,  2,  2,  0,  0,  0,  0 ],
		[  0,  0,  2,  2,  2,  0,  0,  0,  0,  0,  0 ],
		[  0,  0,  2,  0,  0,  0,  0,  0,  0,  0,  0 ]
	]
}