{
	"name": "laser_safety",
	"par": 96,
	"start": [ 4, 0 ],
	"grid": [
		[  0,  0,  0,  1,  1,  1,  0,  0,  0 ],
		[  0,  2,  2,  0,  9,  0,  2,  2,  0 ],
		[  0, 10,  2,  0,  0,  0,  2, 10,  0 ],
		[  0,  2,  0,  0, 10,  0,  0,  2,  0 ],
		[  0,  2, 10,  0,  0,  0, 10,  2,  0 ],
		[ 37,  2,  0,  0,  0,  0,  0,  2, 37 ],
		[  0,  1, 10,  2,  0,  2, 10,  1,  0 ],
		[  0, 10,  0,  0, 10,  0,  0, 10,  0 ],
		[  0,  2,  2,  0,  0,  0,  2,  2,  0 ],
		[  0,  0,  2,  1,  9,  1,  2,  1,  0 ],
		[  0,  0,  0,  0,  1,  0,  0,  0,  0 ],
		[  0,  0,  0,  0,  3,  0,  0,  0,  0 ]
	]
}