{
	"name": "branching_pathway",
	"par": 263,
	"start": [ 4, 3 ],
	"grid": [
		[  0,  0,  0,  2,  0,  2,  0,  0,  0,  0 ],
		[  0,  0,  0,  8,  2,  8,  0,  0,  0,  0 ],
		[  7,  7,  0,  0,  1,  0,  0,  0,  0,  0 ],
		[  0,  0,  7,  1,  1, 65,  7,  7,  7,  7 ],
		[  4,  0,  0,  7,  0,  7,  0,  0,  7,  0 ],
		[  1,  0,  0,  7,  0,  7,  0,  0,  7,  0 ],
		[  1,  0,  0,  4,  0,  0,  7,  0,  0,  0 ],
		[  1,  0,  0,  0,  0,  7,  7,  0,  0,  0 ],
		[ 65,  1,  0,  7,  4,  0,  0,  0,  0,  0 ],
		[  0,  0,  7,  0,  7,  0,  0,  0,  0,  0 ]
	]
}