{
	"name": "branching_pathway",
	"par": 263,
	"start": [ 4, 3 ],
	"grid": [
		[  0,  0,  0,  0,  0,  2,  0,  0,  0,  0 ],
		[  0,  0,  0,  2,  2,  8,  0,  0,  7,  7 ],
		[  0,  0,  0,  8,  1,  0,  7,  7,  7,  0 ],
		[  0,  0,  0,  0,  1, 65,  0,  0,  7,  0 ],
		[  7,  7,  7,  1,  0,  7,  0,  0,  0,  0 ],
		[  0,  0,  0,  7,  0,  7,  7,  0,  0,  0 ],
		[  4,  0,  0,  7,  0,  0,  7,  0,  0,  0 ],
		[  1,  0,  0,  4,  0,  7,  0,  0,  0,  0 ],
		[  1,  0,  0,  0,  4,  0,  0,  0,  0,  0 ],
		[  1,  0,  0,  7,  7,  0,  0,  0,  0,  0 ],
		[ 65,  1,  7,  0,  0,  0,  0,  0,  0,  0 ]
	]
}