{
	"name": "outposts",
	"par": 23,
	"start": [ 6, 6 ],
	"grid": [
		[  0,  0,  0,  0,  0,  0,  0,  0,  0,  0,  0,  0,  1 ],
		[  0,  0,  0,  0,  0,  0,  0,  0,  0,  0,  0,  0, 14 ],
		[  0,  0,  0,  0,  0,  0,  0,  0,  0,  0,  0,  0,  0 ],
		[  0,  0,  0,  0,  0,  0,  0,  0,  0,  0,  0,  0,  0 ],
		[  0,  0,  0,  0,  0,  0,  0,  0,  0,  0,  0,  0,  0 ],
		[  0,  0,  0,  0,  0,  0,  0, 14,  0,  0,  0,  0,  0 ],
		[  1, 14,  0,  0,  0, 14,  1,  4,  0,  0,  0,  0,  0 ],
		[ 14,  0,  0,  0,  0,  4,  2,  2,  0,  0,  0,  0,  0 ],
		[  0,  0,  0,  0,  0,  2,  0,  2,  0,  0,  0,  0,  0 ],
		[  0,  0,  0,  0,  0,  2,  2,  0,  0,  0,  0,  0,  0 ],
		[  0,  0,  0,  0,  0,  0,  2,  0,  0,  0,  0,  0, 14 ],
		[  0,  0,  0,  0,  0,  0,  1, 14,  0,  0,  0, 14,  1 ],
		[  0,  0,  0,  0,  0, 14,  0,  0,  0,  0,  0,  0,  0 ],
		[  0,  0,  0,  0,  0,  0,  0,  0,  0,  0,  0,  0,  0 ],
		[  0,  0,  0,  0,  0,  0,  0,  0,  0,  0,  0,  0,  0 ],
		[  0,  0,  0,  0,  0,  0,  0,  0,  0,  0,  0,  0,  0 ],
		[ 14,  0,  0,  0,  0,  0,  0,  0,  0,  0,  0,  0,  0 ],
		[  1,  0,  0,  0,  0,  0,  0,  0,  0,  0,  0,  0,  0 ]
	]
}