{
	"name": "roundabouts",
	"par": 37,
	"start": [ 0, 12 ],
	"grid": [
		[  0,  0,  0,  0,  0,  0,  0,  0,  0,  2,  2,  2,  2 ],
		[  0,  0,  0,  0,  0,  0,  0,  0,  2,  0,  2,  2, 10 ],
		[  0,  0,  0,  0,  0,  0,  0,  0,  2,  1, 10,  0, 10 ],
		[  0,  0,  0,  0,  0,  2,  2,  0,  0, 10,  2,  2,  2 ],
		[  0,  0,  0,  0,  2, 10,  2, 10, 10,  2, 10, 10,  2 ],
		[  0,  0,  0,  0,  2,  2,  0, 10,  0,  2, 10,  2,  0 ],
		[  0,  0,  0, 10,  0,  2,  2,  0,  0,  2,  2,  0,  0 ],
		[  0,  0,  1,  0,  2, 10,  2,  0,  0,  0,  0,  0,  0 ],
		[  0,  0, 10,  0,  2,  2,  0,  0,  0,  0,  0,  0,  0 ],
		[  0,  0,  2,  2,  0, 10,  0,  0,  0,  0,  0,  0,  0 ],
		[  0,  2, 10,  2,  0,  1,  0,  0,  0,  0,  0,  0,  0 ],
		[  0,  2,  2,  0,  0,  0,  0,  0,  0,  0,  0,  0,  0 ],
		[  1,  0,  0,  0,  0,  0,  0,  0,  0,  0,  0,  0,  0 ]
	]
}