{
	"name": "two_fish",
	"par": 104,
	"start": [ 0, 4 ],
	"grid": [
		[  0,  0,  0,  0,  0,  0,  0,  0,  0,  0,  0,  7,  0 ],
		[  0,  0,  8,  8,  8,  0,  0,  0,  0,  0,  7,  0,  7 ],
		[  0,  0,  0,  8,  3,  8,  3,  3,  3,  2,  7,  2,  7 ],
		[  0,  0,  0,  8,  3,  8,  3, 15,  3,  2,  7,  2,  0 ],
		[  3,  8,  3,  8,  3,  8,  3,  3,  7,  2,  7,  2,  7 ],
		[  3,  8,  3,  8,  3,  8,  3,  7, 15,  2,  7,  2,  7 ],
		[  0,  8,  3,  8,  3,  8,  0,  7,  7,  2,  0,  0,  0 ],
		[  0,  8,  3,  8,  3,  0,  0,  0,  0,  0,  0,  0,  0 ],
		[  3,  8,  0,  0,  0,  0,  0,  0,  0,  0,  0,  0,  0 ],
		[  3,  0,  0,  0,  0,  0,  0,  0,  0,  0,  0,  0,  0 ]
	]
}