{
	"name": "not_a_knot",
	"par": 63,
	"start": [ 0, 7 ],
	"grid": [
		[  0,  0,  0,  0,  0,  0,  0,  3,  3,  3,  3,  3,  3 ],
		[  0,  0,  0,  0,  0,  0,  3,  0,  0,  0,  3,  0,  3 ],
		[  0,  0,  0,  0,  0,  3,  0,  2,  2,  1,  3,  3,  0 ],
		[  0,  0,  0,  0,  0,  3,  2,  2,  2,  0,  3,  0,  0 ],
		[  0,  0,  2,  2,  2,  1,  2,  2,  0,  3,  0,  0,  0 ],
		[  0,  2,  2,  2,  2,  3,  0,  0,  3,  0,  0,  0,  0 ],
		[  3,  2,  0,  2,  0,  3,  3,  3,  0,  0,  0,  0,  0 ],
		[  1,  0,  2,  2,  0,  3,  3,  3,  0,  0,  0,  0,  0 ],
		[  1,  2,  2,  0,  3,  3,  3,  0,  0,  0,  0,  0,  0 ],
		[  3,  2,  0,  3,  0,  3,  0,  0,  0,  0,  0,  0,  0 ],
		[  3,  3,  3,  3,  3,  0,  0,  0,  0,  0,  0,  0,  0 ]
	]
}