{
	"name": "a_mountain",
	"par": 69,
	"start": [ 2, 7 ],
	"grid": [
		[  0,  0,  0,  3,  3,  3,  3,  3,  3,  3,  0 ],
		[  0,  0,  3,  3,  3,  3,  3,  3,  3,  3,  1 ],
		[  0,  3,  3,  2,  2,  2,  2,  2,  3,  3,  0 ],
		[  3,  3,  2,  1,  4,  3,  1,  2,  3,  3,  0 ],
		[  3,  3,  2,  3,  3,  4,  2,  3,  3,  0,  0 ],
		[  3,  3,  2,  4,  3,  2,  3,  3,  0,  0,  0 ],
		[  3,  3,  2,  1,  2,  3,  3,  0,  0,  0,  0 ],
		[  3,  3,  2,  2,  3,  3,  0,  0,  0,  0,  0 ],
		[  3,  3,  3,  3,  3,  0,  0,  0,  0,  0,  0 ],
		[  3,  3,  3,  3,  0,  0,  0,  0,  0,  0,  0 ]
	]
}