{
	"name": "another_mountain",
	"par": 70,
	"start": [ 2, 5 ],
	"grid": [
		[  0,  0,  0,  3,  3,  3,  3,  3,  3,  3,  0 ],
		[  0,  0,  3,  3,  3,  3,  3,  3,  3,  3,  1 ],
		[  0,  3,  3,  2,  2,  2,  2,  2,  3,  3,  0 ],
		[  3,  3,  2,  3,  4,  3,  3,  2,  3,  3,  0 ],
		[  3,  3,  2,  3,  3,  4,  2,  3,  3,  0,  0 ],
		[  3,  3,  2,  4,  3,  2,  3,  3,  0,  0,  0 ],
		[  3,  3,  2,  3,  2,  3,  3,  0,  0,  0,  0 ],
		[  3,  3,  2,  2,  3,  3,  0,  0,  0,  0,  0 ],
		[  3,  3,  3,  3,  3,  0,  0,  0,  0,  0,  0 ],
		[  3,  3,  3,  3,  0,  0,  0,  0,  0,  0,  0 ]
	]
}