{
	"name": "island",
	"par": 361,
	"start": [ 0, 7 ],
	"grid": [
		[  0,  0,  0,  0,  0,  7,  7,  7,  7,  7 ],
		[  0,  0,  0,  0,  7,  0,  0,  0,  0,  7 ],
		[  0,  0,  0,  7,  0,  0,  0,  0,  0,  7 ],
		[  0,  0,  7,  0,  0,  8,  8,  0,  0,  7 ],
		[  0,  7,  0,  0,  8,  2,  8,  0,  7,  0 ],
		[  0,  7,  0,  0,  8,  8,  0,  7,  0,  0 ],
		[  7,  0,  0,  7,  0,  0,  7,  0,  0,  0 ],
		[  7,  7,  7,  0,  0,  7,  0,  0,  0,  0 ],
		[  7,  0,  0,  0,  7,  0,  0,  0,  0,  0 ],
		[  7,  0,  7,  7,  0,  0,  0,  0,  0,  0 ],
		[  7,  7,  0,  0,  0,  0,  0,  0,  0,  0 ]
	]
}