{
	"name": "stripes",
	"par": 140,
	"start": [ 0, 8 ],
	"grid": [
		[  0,  0,  0,  0,  0,  2,  0,  0,  0 ],
		[  0,  0,  0,  2,  7,  2,  0,  0,  0 ],
		[  0,  2,  7,  2,  7,  2,  0,  0,  0 ],
		[  7,  2,  7,  2,  7,  2,  0,  0,  0 ],
		[  7,  2,  7,  2,  7,  2,  0,  0,  0 ],
		[  7,  2,  7,  2,  7,  2,  3,  3,  3 ],
		[  7,  2,  7,  2,  7,  3,  8,  3,  0 ],
		[  7,  2,  7,  0,  3,  3,  3,  0,  0 ],
		[  7,  0,  0,  0,  0,  0,  0,  0,  0 ]
	]
}