{
	"name": "stripes",
	"par": 140,
	"start": [ 0, 6 ],
	"grid": [
		[  0,  2,  0,  2,  0,  2,  0,  0,  0 ],
		[  7,  2,  7,  2,  7,  2,  0,  0,  0 ],
		[  7,  2,  7,  2,  7,  2,  0,  0,  0 ],
		[  7,  2,  7,  2,  7,  2,  0,  0,  0 ],
		[  7,  2,  7,  2,  7,  2,  0,  0,  0 ],
		[  7,  2,  7,  2,  7,  2,  0,  0,  0 ],
		[  7,  0,  7,  0,  7,  3,  3,  3,  0 ],
		[  0,  0,  0,  0,  3,  3,  8,  3,  3 ],
		[  0,  0,  0,  0,  0,  0,  3,  0,  0 ]
	]
}