{
	"name": "turtle",
	"par": 57,
	"start": [ 8, 5 ],
	"grid": [
		[  0,  0,  0,  0,  7,  0,  0,  0,  0 ],
		[  0,  0,  0,  0,  2,  0,  0,  0,  2 ],
		[  0,  0,  0,  0,  2,  2,  2,  2,  0 ],
		[  0,  0,  0,  2,  4,  2,  4,  2,  0 ],
		[  0,  0,  2,  2,  2,  2,  2,  2,  0 ],
		[  2,  2,  4,  2,  4,  2,  4,  7,  7 ],
		[  0,  2,  2,  2,  2,  2,  2,  0,  0 ],
		[  0,  2,  4,  2,  4,  2,  0,  0,  0 ],
		[  0,  2,  2,  2,  2,  0,  0,  0,  0 ],
		[  2,  0,  0,  0,  0,  0,  0,  0,  0 ]
	]
}