{
	"name": "wand",
	"par": 82,
	"start": [ 3, 7 ],
	"grid": [
		[  0,  0,  0,  0,  0,  0,  0,  0,  0,  0,  8 ],
		[  0,  0,  0,  0,  0,  0,  0,  0,  0,  4,  0 ],
		[  0,  0,  0,  0,  0,  0,  0,  0,  2,  0,  0 ],
		[  0,  0,  0,  0,  7,  7,  2,  4,  0,  0,  0 ],
		[  0,  0,  0,  7,  0,  2,  7,  2,  0,  0,  0 ],
		[  0,  0,  0,  7,  0,  4,  2,  7,  0,  0,  0 ],
		[  0,  0,  0,  7,  0,  0,  0,  7,  0,  0,  0 ],
		[  0,  0,  8,  4,  7,  7,  7,  0,  0,  0,  0 ],
		[  0,  1,  2,  8,  0,  0,  0,  0,  0,  0,  0 ],
		[  1,  3,  1,  0,  0,  0,  0,  0,  0,  0,  0 ],
		[  1,  1,  0,  0,  0,  0,  0,  0,  0,  0,  0 ]
	]
}