{
	"par": 82,
	"start": [ 3, 3 ],
	"grid": [
		[  0,  0,  0,  7,  7,  7,  0,  0,  0,  4,  8 ],
		[  0,  0,  0,  7,  0,  2,  2,  4,  2,  0,  0 ],
		[  0,  0,  0,  7,  0,  4,  7,  2,  0,  0,  0 ],
		[  0,  1,  8,  4,  0,  0,  2,  7,  0,  0,  0 ],
		[  1,  3,  2,  8,  7,  7,  0,  7,  0,  0,  0 ],
		[  1,  1,  1,  0,  0,  0,  7,  0,  0,  0,  0 ]
	]
}