{
	"name": "all_wound_up",
	"par": 98,
	"start": [ 2, 5 ],
	"grid": [
		[  3,  3,  0,  0,  0,  0,  0,  0,  0,  0,  0,  0,  0 ],
		[  3,  3,  0,  1,  0,  2,  0,  2,  0,  2,  2,  1,  0 ],
		[  8,  4,  0,  0,  7,  0,  2,  2,  2,  2,  2,  7,  0 ],
		[  3,  3,  0,  4,  2,  2,  0,  2,  2,  2,  0,  0,  2 ],
		[  3,  4,  0,  0,  2,  2,  2,  0,  0,  0,  2,  2,  2 ],
		[  8,  3,  1,  2,  2,  0,  0,  0,  0,  0,  0,  2,  2 ],
		[  3,  3,  2,  2,  0,  0,  0,  0,  1,  7,  2,  0,  2 ],
		[  3,  3,  2,  0,  2,  2,  0,  2,  2,  0,  2,  2,  2 ],
		[  3,  1,  7,  2,  2,  2,  2,  2,  2,  0,  0,  0,  0 ],
		[  0,  0,  0,  0,  0,  0,  2,  0,  0,  0,  0,  0,  0 ]
	]
}