{
	"name": "toughened_tiles",
	"par": 124,
	"start": [ 0, 9 ],
	"grid": [
		[  0,  0,  0,  0,  0,  0,  0,  0,  0,  0,  2,  0,  0 ],
		[  0,  0,  0,  0,  0,  0,  0,  8,  1,  8,  0,  0,  0 ],
		[  0,  0,  0,  0,  0,  0,  1,  0,  0,  2,  2,  0,  0 ],
		[  0,  0,  0,  0,  0,  1,  0,  0,  0,  2,  0,  2,  2 ],
		[  0,  0,  0,  0,  1,  0,  0,  0,  0,  2,  8,  2,  2 ],
		[  0,  0,  0,  1,  0,  0,  0,  0,  2,  2,  0,  0,  0 ],
		[  0,  0,  1,  0,  0,  0,  0,  2,  2,  2,  0,  0,  0 ],
		[  0,  1,  0,  7,  7,  0,  2,  2,  2,  2,  0,  0,  0 ],
		[  8,  0,  7,  0,  7,  8,  2,  2,  2,  0,  0,  0,  0 ],
		[  1,  7,  0,  0,  2,  0,  2,  2,  0,  0,  0,  0,  0 ],
		[  8,  2,  2,  2,  0,  0,  0,  0,  0,  0,  0,  0,  0 ]
	]
}