{
	"name": "one_two_one_two",
	"par": 101,
	"start": [ 7, 3 ],
	"grid": [
		[  0,  0,  0,  0,  0,  0,  0,  3,  0,  0,  0,  0 ],
		[  0,  0,  0,  0,  3,  3,  3,  0,  0,  7,  0,  7 ],
		[  0,  0,  0,  3,  7,  3,  0,  4,  0,  2,  2,  0 ],
		[  0,  0,  3,  7,  3,  0,  0,  7,  2,  6,  2,  7 ],
		[  0,  0,  3,  3,  0,  0,  2,  0,  2,  2,  0,  0 ],
		[  0,  0,  0,  0,  0,  2,  0,  1,  0,  0,  0,  0 ],
		[  0,  0,  0,  0,  0,  1,  6,  1,  7,  7,  7,  6 ],
		[  0,  0,  0,  0,  0,  1,  1,  0,  2,  0,  0,  0 ],
		[  0,  7,  7,  7,  7,  0,  2,  7,  0,  0,  0,  0 ],
		[  2,  6,  6,  6,  7,  0,  0,  0,  0,  0,  0,  0 ],
		[  7,  7,  7,  7,  0,  0,  0,  0,  0,  0,  0,  0 ]
	]
}