{
	"name": "nucleus",
	"par": 119,
	"start": [ 4, 4 ],
	"grid": [
		[  0,  0,  0,  0,  2,  7,  2,  2,  2 ],
		[  0,  0,  0,  2,  2,  0,  0,  2,  7 ],
		[  0,  0,  2,  0,  9,  9,  9,  0,  7 ],
		[  0,  2,  0,  9,  4,  2,  9,  0,  2 ],
		[  2,  2,  9,  3,  9,  3,  9,  2,  2 ],
		[  2,  0,  9,  3,  2,  9,  0,  2,  0 ],
		[  7,  0,  9,  9,  9,  0,  2,  0,  0 ],
		[  7,  2,  0,  0,  2,  7,  0,  0,  0 ],
		[  2,  2,  2,  2,  2,  0,  0,  0,  0 ]
	]
}