{
	"name": "sniper",
	"par": 56,
	"start": [ 10, 8 ],
	"grid": [
		[  0,  0,  0,  0,  0,  0,  0,  0,  0,  0,  0,  0,  2 ],
		[  0,  0,  0,  0,  0,  0,  0,  0,  0,  0,  2,  4,  2 ],
		[  0,  0,  0,  0,  0,  0,  0,  0,  0,  0,  0,  0,  1 ],
		[  0,  0,  0,  0,  0,  0,  0,  0,  2,  4,  2,  0,  1 ],
		[  0,  0,  0,  0,  0,  0,  0,  2,  2,  0,  0,  9,  1 ],
		[  0,  0,  0,  0,  1,  0,  4,  2,  0,  0,  9,  1,  1 ],
		[  0,  0,  0,  4,  0,  2,  0,  2,  0,  9,  1,  1,  1 ],
		[  0,  0,  1,  1,  0,  0,  2,  0,  9,  1,  1,  1,  1 ],
		[  1,  3,  0,  1,  0,  0,  0,  9,  1,  1,  1,  0,  0 ],
		[  0,  2,  0,  1,  0,  0,  9,  1,  1,  0,  0,  0,  0 ],
		[  4,  2,  1,  1,  1,  1,  1,  0,  0,  0,  0,  0,  0 ],
		[  1,  0,  0,  0,  0,  0,  0,  0,  0,  0,  0,  0,  0 ]
	]
}