{
	"name": "laser_tiles",
	"par": 68,
	"start": [ 0, 6 ],
	"grid": [
		[  0,  0,  0,  0,  0,  0,  0,  0,  0,  0,  0,  6,  0 ],
		[  0,  0,  0,  0,  0,  0,  0,  0,  0,  0,  6,  9,  3 ],
		[  0,  6,  0,  0,  0,  0,  0,  2,  0,  0,  0,  3,  6 ],
		[  0,  0,  0,  1,  1,  1,  1,  9,  2,  0,  0,  0,  0 ],
		[  0,  2,  0,  1,  0,  9,  3,  1,  2,  0,  0,  0,  0 ],
		[  2,  0,  2,  0,  0,  0,  9,  0,  0,  0,  0,  0,  0 ],
		[  1,  2,  2,  2,  2,  0,  0,  0,  2,  0,  0,  0,  0 ],
		[  2,  2,  2,  0,  0,  3,  0,  0,  0,  0,  3,  0,  0 ]
	]
}