{
	"name": "deathtrap",
	"par": 295,
	"start": [ 1, 10 ],
	"grid": [
		[  0,  0,  0,  0,  0,  0,  0,  0,  0,  0,  0,  0,  2 ],
		[  0,  0,  0,  0,  0,  0,  0,  0,  0,  0,  0,  9,  0 ],
		[  0,  0,  0,  0,  0,  0,  0,  0,  0,  9,  9,  2,  9 ],
		[  0,  0,  0,  0,  0,  0,  9,  9,  9,  2,  9,  2,  9 ],
		[  0,  0,  0,  9,  9,  9,  0,  9,  9,  9,  9,  9,  9 ],
		[  0,  0,  9,  9,  0,  9,  9,  2,  2,  0,  9,  0,  9 ],
		[  0,  0,  0,  9,  2,  9,  0,  9,  9,  7,  9,  9,  2 ],
		[  0,  0,  2,  9,  9,  9,  9,  0,  9,  9,  8,  9,  2 ],
		[  0,  0,  9,  9,  0,  2,  9,  9,  8,  9,  9,  0,  0 ],
		[  0,  2,  9,  0,  0,  9,  3,  9,  9,  0,  0,  0,  0 ],
		[  2,  2,  9,  9,  3,  9,  9,  0,  0,  0,  0,  0,  0 ],
		[  2,  2,  0,  9,  9,  0,  0,  0,  0,  0,  0,  0,  0 ]
	]
}