{
	"name": "eagerness",
	"par": 110,
	"start": [ 2, 3 ],
	"grid": [
		[  0,  0,  0,  7,  1,  1,  0,  0,  0,  0,  0,  0 ],
		[  0,  0,  1,  0,  0,  1,  0,  0,  0,  0,  0,  0 ],
		[  0,  0,  1,  0,  1,  0,  0,  0,  0,  9,  0,  0 ],
		[  0,  1,  1,  1,  0,  0,  0,  3,  9,  1,  0,  0 ],
		[  1,  0,  0,  0,  2,  9,  4,  4,  1,  1,  0,  0 ],
		[  7,  0,  1,  0,  0,  4,  1,  0,  8,  0,  8,  0 ],
		[  1,  1,  1,  0,  0,  3,  4,  8,  1,  1,  8,  0 ],
		[  0,  0,  0,  0,  0,  9,  1,  1,  0,  8,  3,  9 ],
		[  0,  0,  0,  0,  0,  9,  1,  0,  8,  0,  0,  0 ]
	]
}