{
	"name": "eagerness",
	"par": 110,
	"start": [ 2, 4 ],
	"grid": [
		[  0,  0,  0,  0,  1,  1,  0,  0,  0,  9,  0,  0 ],
		[  0,  0,  0,  7,  0,  1,  0,  0,  9,  1,  0,  0 ],
		[  0,  0,  1,  0,  1,  0,  0,  3,  1,  1,  8,  0 ],
		[  0,  0,  1,  0,  0,  0,  4,  4,  8,  0,  8,  0 ],
		[  0,  0,  1,  1,  2,  9,  1,  0,  1,  1,  3,  9 ],
		[  0,  1,  0,  0,  0,  4,  4,  8,  0,  8,  0,  0 ],
		[  1,  0,  1,  0,  0,  3,  1,  1,  8,  0,  0,  0 ],
		[  7,  0,  1,  0,  0,  9,  1,  0,  0,  0,  0,  0 ],
		[  1,  1,  0,  0,  0,  9,  0,  0,  0,  0,  0,  0 ]
	]
}