{
	"name": "gun_platform",
	"par": 162,
	"start": [ 0, 5 ],
	"grid": [
		[  0,  0,  0,  7,  0,  7,  0,  7,  0,  0,  0,  0 ],
		[  0,  7,  7,  0,  7,  7,  7,  0,  7,  7,  0,  0 ],
		[  7,  0,  0,  2,  0,  4,  0,  2,  0,  0,  7,  7 ],
		[  7,  0,  0,  0,  0,  9,  0,  0,  0,  2,  0,  7 ],
		[  7,  0,  2,  0,  9,  2,  9,  0,  0,  0,  0,  7 ],
		[  7,  7,  0,  7,  9,  9,  9,  0,  0,  2,  0,  7 ],
		[  7,  0,  7,  0,  0,  0,  0,  0,  0,  2,  0,  2 ],
		[  7,  0,  0,  0,  2,  0,  2,  0,  2,  0,  0,  7 ],
		[  7,  7,  7,  7,  0,  7,  0,  7,  0,  7,  7,  0 ],
		[  0,  0,  0,  0,  7,  0,  2,  0,  7,  0,  0,  0 ]
	]
}