{
	"name": "deadly_snowflake",
	"par": 94,
	"start": [ 0, 5 ],
	"grid": [
		[  0,  0,  0,  0,  2,  0,  0,  0 ],
		[  0,  0,  0,  0,  2,  2,  2,  2 ],
		[  0,  0,  0,  2,  9,  0,  9,  2 ],
		[  1,  0,  2,  0,  9,  9,  0,  2 ],
		[  1,  2,  9,  9,  0,  9,  9,  2 ],
		[  1,  2,  0,  9,  9,  0,  4,  2 ],
		[  1,  2,  9,  0,  9,  2,  2,  0 ],
		[  1,  2,  4,  2,  2,  0,  0,  0 ],
		[  1,  2,  2,  0,  0,  0,  0,  0 ]
	]
}