{
	"name": "trigger_happy",
	"par": 218,
	"start": [ 11, 6 ],
	"grid": [
		[  0,  0,  0,  0,  0,  0,  0,  0,  0,  2,  0,  0,  0 ],
		[  0,  0,  0,  0,  0,  0,  0,  0,  1,  9,  1,  1,  0 ],
		[  0,  0,  0,  0,  0,  8,  3,  1,  1,  9,  9,  3,  3 ],
		[  0,  0,  0,  0,  8,  9,  0,  1,  0,  9,  1,  9,  3 ],
		[  0,  0,  0,  8,  3,  0,  1,  2,  0,  1,  9,  0,  0 ],
		[  0,  0,  8,  9,  0,  1,  0,  2,  0,  9,  1,  9,  0 ],
		[  0,  3,  3,  0,  1,  2,  2,  0,  0,  1,  9,  1,  0 ],
		[  1,  0,  0,  1,  0,  0,  2,  9,  0,  9,  1,  0,  0 ],
		[  1,  0,  1,  2,  2,  2,  2,  9,  0,  9,  0,  0,  0 ],
		[  1,  1,  0,  0,  2,  0,  2,  0,  0,  0,  0,  0,  0 ],
		[  7,  3,  3,  0,  2,  2,  0,  0,  0,  0,  0,  0,  0 ],
		[  3,  3,  3,  0,  0,  0,  0,  0,  0,  0,  0,  0,  0 ],
		[  3,  3,  0,  0,  0,  0,  0,  0,  0,  0,  0,  0,  0 ]
	]
}