{
	"name": "maze",
	"par": 291,
	"start": [ 0, 10 ],
	"grid": [
		[  0,  0,  0,  0,  0,  0,  0,  0,  0,  0,  3,  3 ],
		[  0,  0,  0,  0,  0,  0,  0,  0,  0,  3,  3,  2 ],
		[  0,  0,  0,  0,  0,  0,  0,  0,  0,  9,  5,  7 ],
		[  0,  0,  0,  0,  0,  0,  2,  2,  2,  2,  7,  0 ],
		[  0,  0,  0,  0,  0,  2,  0,  0,  0,  0,  7,  0 ],
		[  0,  0,  0,  0,  0,  7,  2,  0,  0,  0,  2,  2 ],
		[  0,  2,  0,  0,  7,  0,  7,  2,  2,  0,  7,  2 ],
		[  7,  0,  0,  7,  0,  2,  0,  0,  2,  0,  4,  0 ],
		[  7,  0,  2,  7,  0,  2,  0,  0,  2,  0,  9,  0 ],
		[  7,  0,  2,  2,  0,  7,  0,  2,  0,  0,  7,  5 ],
		[  7,  0,  0,  0,  0,  7,  2,  0,  0,  0,  7,  0 ],
		[  2,  7,  2,  2,  2,  0,  0,  0,  0,  0,  0,  0 ],
		[  0,  7,  0,  2,  0,  0,  0,  0,  0,  0,  0,  0 ],
		[  0,  7,  2,  0,  0,  0,  0,  0,  0,  0,  0,  0 ],
		[  2,  0,  0,  0,  0,  0,  0,  0,  0,  0,  0,  0 ]
	]
}