{
	"name": "lure",
	"par": 16,
	"start": [ 1, 5 ],
	"grid": [
		[  0,  0,  0,  1,  1,  1 ],
		[  0,  0,  1,  1,  1,  4 ],
		[  0,  1,  1,  1,  1,  0 ],
		[  0,  4,  1,  1,  2,  2 ],
		[  0,  0,  2,  2,  2,  0 ],
		[  2,  5,  2,  0,  0,  0 ],
		[  2,  2,  1,  3,  0,  0 ],
		[  2,  0,  0,  0,  0,  0 ]
	]
}