{
	"name": "all_about_preparation",
	"par": 78,
	"start": [ 1, 5 ],
	"grid": [
		[  0,  0,  0,  1,  0,  1,  0,  1,  0,  1,  0,  0 ],
		[  0,  1,  1,  1,  2,  0,  1,  1,  2,  1,  1,  1 ],
		[  2,  2,  0,  0,  2,  1,  3,  3,  2,  0,  1,  1 ],
		[  1,  0,  2,  4,  0,  0,  5,  0,  0,  0,  5,  3 ],
		[  1,  0,  3,  0,  0,  3,  3,  0,  3,  3,  3,  0 ],
		[  1,  1,  0,  0,  4,  3,  0,  0,  0,  3,  0,  0 ],
		[  0,  0,  1,  2,  0,  0,  0,  3,  3,  3,  0,  0 ],
		[  0,  0,  1,  2,  1,  1,  5,  3,  0,  3,  5,  1 ],
		[  0,  0,  0,  0,  1,  1,  0,  0,  0,  0,  1,  0 ],
		[  0,  0,  0,  0,  0,  0,  1,  1,  2,  1,  1,  0 ],
		[  0,  0,  0,  0,  0,  0,  0,  0,  2,  0,  0,  0 ]
	]
}