{
	"name": "all_about_preparation",
	"par": 78,
	"start": [ 1, 9 ],
	"grid": [
		[  0,  0,  0,  0,  0,  0,  0,  0,  0,  1,  1,  1 ],
		[  0,  0,  0,  0,  0,  0,  0,  1,  2,  1,  1,  1 ],
		[  0,  0,  0,  0,  0,  1,  1,  1,  2,  0,  5,  3 ],
		[  0,  0,  0,  1,  2,  0,  3,  3,  0,  0,  3,  0 ],
		[  0,  0,  1,  1,  2,  1,  5,  0,  3,  3,  0,  0 ],
		[  0,  1,  0,  0,  0,  0,  3,  0,  0,  3,  0,  0 ],
		[  2,  2,  2,  4,  0,  3,  0,  0,  3,  3,  5,  1 ],
		[  1,  0,  3,  0,  4,  3,  0,  3,  0,  3,  1,  0 ],
		[  1,  0,  0,  0,  0,  0,  5,  3,  0,  0,  1,  0 ],
		[  1,  1,  1,  2,  1,  1,  0,  0,  2,  1,  0,  0 ],
		[  0,  0,  1,  2,  1,  1,  1,  1,  2,  0,  0,  0 ]
	]
}