{
	"name": "revolver_cannon",
	"par": 209,
	"start": [ 0, 5 ],
	"grid": [
		[  0,  0,  0,  0,  2,  0,  6,  6,  6,  6 ],
		[  0,  0,  1,  8,  2,  6,  2,  9,  2,  6 ],
		[  0,  1,  1,  0,  7,  6,  6,  6,  6,  0 ],
		[  1,  1,  1,  0,  0,  6,  9,  0,  0,  0 ],
		[  1,  1,  1,  0,  0,  0,  0,  7,  9,  0 ],
		[  1,  1,  1,  0,  0,  7,  7,  5,  7,  0 ],
		[  1,  1,  1,  1,  7,  5,  7,  7,  0,  0 ],
		[  1,  0,  0,  0,  7,  7,  0,  0,  0,  0 ]
	]
}