{
	"name": "switch",
	"par": 61,
	"start": [ 0, 6 ],
	"grid": [
		[  0,  0,  0,  2,  0,  0,  0,  0,  0,  0 ],
		[  0,  0,  2,  9,  2,  0,  0,  0,  0,  0 ],
		[  0,  0,  2,  2,  2,  9,  0,  4,  2,  2 ],
		[  3,  0,  0,  4,  9,  9,  9,  2,  2,  2 ],
		[  3,  1,  4,  5,  0,  9,  9,  0,  2,  0 ],
		[  1,  4,  0,  4,  4,  0,  0,  0,  5,  2 ],
		[  1,  1,  1,  0,  0,  1,  4,  1,  0,  0 ],
		[  0,  0,  0,  9,  1,  1,  0,  1,  0,  0 ],
		[  0,  0,  0,  1,  0,  1,  1,  0,  0,  0 ],
		[  0,  0,  0,  0,  1,  0,  0,  0,  0,  0 ]
	]
}