{
	"name": "switch",
	"par": 61,
	"start": [ 0, 8 ],
	"grid": [
		[  0,  0,  0,  0,  0,  0,  0,  0,  2,  2 ],
		[  0,  0,  0,  2,  2,  0,  0,  4,  2,  2 ],
		[  0,  0,  2,  9,  2,  9,  9,  2,  2,  0 ],
		[  0,  0,  2,  2,  9,  9,  9,  0,  5,  2 ],
		[  0,  0,  0,  4,  0,  9,  0,  0,  0,  0 ],
		[  3,  0,  4,  5,  4,  0,  4,  1,  0,  0 ],
		[  3,  1,  0,  4,  0,  1,  0,  1,  0,  0 ],
		[  1,  4,  1,  0,  1,  1,  1,  0,  0,  0 ],
		[  1,  1,  0,  9,  0,  1,  0,  0,  0,  0 ],
		[  0,  0,  0,  1,  1,  0,  0,  0,  0,  0 ]
	]
}