{
	"name": "spinner_tiles",
	"par": 29,
	"start": [ 1, 3 ],
	"grid": [
		[  0,  0,  0,  0,  0,  0,  0,  0,  2,  2,  0,  0 ],
		[  0,  0,  0,  0,  0,  0,  0,  2,  5,  0,  0,  2 ],
		[  0,  1,  1,  0,  0,  0,  2,  0,  0,  2,  5,  2 ],
		[  1,  1,  0,  0,  0,  0,  0,  0,  0,  2,  0,  0 ],
		[  0,  1,  2,  0,  0,  0,  5,  0,  2,  0,  0,  0 ],
		[  2,  2,  1,  0,  0,  0,  0,  0,  1,  1,  0,  0 ],
		[  0,  5,  0,  1,  5,  0,  0,  1,  1,  0,  0,  0 ]
	]
}