{
	"name": "spinner_tiles",
	"par": 29,
	"start": [ 1, 1 ],
	"grid": [
		[  0,  1,  0,  0,  0,  0,  0,  0,  0,  0,  0,  0 ],
		[  1,  1,  1,  0,  0,  0,  0,  0,  0,  0,  0,  0 ],
		[  0,  1,  0,  0,  0,  0,  0,  2,  2,  2,  0,  0 ],
		[  2,  2,  2,  0,  0,  0,  2,  0,  5,  0,  0,  0 ],
		[  0,  5,  1,  0,  0,  0,  0,  0,  0,  2,  0,  2 ],
		[  0,  0,  0,  1,  0,  0,  5,  0,  0,  2,  5,  2 ],
		[  0,  0,  0,  0,  5,  0,  0,  0,  2,  0,  0,  0 ],
		[  0,  0,  0,  0,  0,  0,  0,  1,  1,  1,  0,  0 ],
		[  0,  0,  0,  0,  0,  0,  0,  0,  1,  0,  0,  0 ]
	]
}