{
	"name": "three_more_ways",
	"par": 41,
	"start": [ 6, 6 ],
	"grid": [
		[  0,  0,  0,  0,  0,  0,  0,  0,  0,  6,  0,  0,  0 ],
		[  0,  0,  0,  0,  0,  0,  0,  0,  2,  2,  0,  0,  0 ],
		[  0,  0,  0,  0,  0,  0,  2,  2,  0,  2,  0,  0,  0 ],
		[  0,  0,  0,  6,  3,  2,  5,  4,  4,  6,  0,  0,  0 ],
		[  0,  0,  0,  1,  0,  6,  2,  0,  0,  0,  0,  0,  0 ],
		[  0,  0,  0,  3,  1,  0,  1,  0,  0,  2,  2,  2,  2 ],
		[  0,  0,  0,  6,  0,  0,  1,  4,  2,  5,  2,  5,  2 ],
		[  0,  0,  0,  0,  0,  1,  0,  0,  6,  6,  2,  4,  0 ],
		[  0,  0,  0,  2,  2,  0,  0,  0,  0,  0,  0,  0,  0 ],
		[  0,  0,  4,  5,  4,  0,  0,  0,  0,  0,  0,  0,  0 ],
		[  0,  0,  2,  2,  0,  0,  0,  0,  0,  0,  0,  0,  0 ],
		[  2,  0,  0,  0,  0,  0,  0,  0,  0,  0,  0,  0,  0 ],
		[  5,  0,  0,  0,  0,  0,  0,  0,  0,  0,  0,  0,  0 ]
	]
}