{
	"name": "three_ways_to_go",
	"par": 32,
	"start": [ 6, 4 ],
	"grid": [
		[  0,  0,  0,  0,  0,  0,  2,  2,  0,  0,  0 ],
		[  0,  0,  0,  0,  0,  3,  5,  2,  0,  0,  0 ],
		[  0,  0,  0,  0,  0,  2,  2,  0,  0,  0,  0 ],
		[  0,  0,  0,  0,  0,  0,  1,  0,  0,  2,  2 ],
		[  0,  0,  0,  0,  0,  0,  1,  1,  2,  5,  2 ],
		[  0,  0,  0,  0,  0,  1,  0,  0,  6,  6,  0 ],
		[  0,  0,  0,  4,  3,  0,  0,  0,  0,  0,  0 ],
		[  0,  0,  3,  5,  4,  0,  0,  0,  0,  0,  0 ],
		[  0,  0,  4,  3,  0,  0,  0,  0,  0,  0,  0 ],
		[  0,  3,  0,  0,  0,  0,  0,  0,  0,  0,  0 ],
		[  3,  0,  0,  0,  0,  0,  0,  0,  0,  0,  0 ]
	]
}