{
	"name": "please_skate_safely",
	"par": 50,
	"start": [ 0, 5 ],
	"grid": [
		[  0,  0,  0,  1,  1,  7,  1,  1 ],
		[  0,  0,  1,  0,  0,  2,  0,  1 ],
		[  0,  7,  0,  9, 10, 10,  2,  1 ],
		[  0,  1, 10, 10,  2, 10,  0,  1 ],
		[  0, 10,  2, 10, 10,  2,  1,  0 ],
		[  1, 10, 10,  9,  0,  7,  0,  0 ],
		[  0,  1,  0,  0,  1,  0,  0,  0 ],
		[  0,  7,  1,  1,  0,  0,  0,  0 ]
	]
}