{
	"name": "please_skate_safely",
	"par": 50,
	"start": [ 0, 4 ],
	"grid": [
		[  0,  0,  0,  1,  0,  0,  0,  0 ],
		[  0,  7,  1,  0,  1,  7,  0,  0 ],
		[  0,  1,  0,  9,  0,  2,  1,  1 ],
		[  0, 10, 10, 10, 10, 10,  0,  1 ],
		[  1, 10,  2, 10,  2, 10,  2,  1 ],
		[  0,  1, 10,  9, 10,  2,  0,  1 ],
		[  0,  7,  0,  0,  0,  7,  1,  0 ],
		[  0,  0,  1,  1,  1,  0,  0,  0 ]
	]
}