{
	"name": "refraction",
	"par": 76,
	"start": [ 0, 1 ],
	"grid": [
		[  0,  1,  0,  0,  0,  0,  0,  0,  0 ],
		[  1,  1,  1,  2,  0,  2,  0,  0,  0 ],
		[  1,  1,  9, 10,  2,  0,  0,  2,  0 ],
		[  0,  0,  0,  2, 10,  9,  2,  2,  2 ],
		[  0,  0,  0,  0,  3,  2,  2,  2,  2 ],
		[  0,  0,  0,  0,  0,  0,  2,  0,  1 ],
		[  0,  0,  0,  0,  0,  0,  0,  2,  2 ],
		[  0,  0,  0,  9,  0,  0,  0,  2,  2 ],
		[  0,  2,  2,  2,  0,  1,  1,  0,  0 ],
		[  0,  0,  2,  1,  1,  0,  0,  0,  0 ]
	]
}