{
	"name": "route_finder",
	"par": 324,
	"start": [ 1, 9 ],
	"grid": [
		[  0,  0,  0,  0,  0,  0,  0,  0,  0,  0,  2,  2,  0,  0 ],
		[  0,  0,  0,  0,  0,  0,  0,  0,  2,  2,  2,  0,  0,  0 ],
		[  0,  0,  0,  0,  0,  0,  0,  2,  2,  0,  2,  0,  0,  8 ],
		[  0,  0,  0,  0,  0,  0,  0,  0,  2,  0,  2,  2,  0,  3 ],
		[  0,  0,  0,  0,  0,  7,  2,  0,  2,  7,  2,  7, 10,  0 ],
		[  0,  0,  0,  2,  2,  7,  7,  7,  7,  2,  0,  7,  0,  0 ],
		[  0,  0,  2,  2,  7,  0,  0,  7,  0,  2,  2, 10,  0,  0 ],
		[  0,  0,  2,  0,  7,  0,  7,  7,  0,  0,  0,  8,  0,  0 ],
		[  0,  2,  0,  7,  7,  0,  7,  7,  2,  2,  8,  0,  0,  0 ],
		[  7,  7,  7,  0,  7,  7,  2,  0,  0,  0,  0,  0,  0,  0 ],
		[  2,  0,  0,  2,  0,  2,  0,  0,  0,  0,  0,  0,  0,  0 ],
		[  2,  2,  2,  2,  2,  0,  0,  0,  0,  0,  0,  0,  0,  0 ],
		[  0,  2,  0,  0,  0,  0,  0,  0,  0,  0,  0,  0,  0,  0 ]
	]
}