{
	"name": "a_slippery_situation",
	"par": 45,
	"start": [ 0, 8 ],
	"grid": [
		[  0,  0,  0,  0,  0,  0,  0,  0,  0, 10,  0,  0,  0 ],
		[  0,  0,  0,  0,  0,  0,  0,  0,  2, 10,  0,  0,  0 ],
		[  0,  0,  0,  0,  0,  0,  0, 10,  2, 10,  0,  7,  7 ],
		[  0,  0,  0,  0,  0,  0,  2, 10,  2, 10,  2,  7,  7 ],
		[  0,  0,  0,  0,  0, 10,  2, 10,  2, 10,  2,  7,  0 ],
		[  0,  0,  0,  2,  2,  0, 10,  0,  0, 10,  0,  0,  0 ],
		[  0,  0,  2, 10,  2,  0,  2,  2, 10,  0,  0,  0,  0 ],
		[  0,  7,  7,  2,  0,  2,  2,  2,  0,  0,  0,  0,  0 ],
		[  2,  7,  0,  0,  0,  2,  2,  0,  0,  0,  0,  0,  0 ]
	]
}