{
	"name": "green_honey",
	"par": 103,
	"start": [ 11, 2 ],
	"grid": [
		[  0,  2,  2,  2,  0,  2,  2,  2,  2,  2,  0,  2,  0 ],
		[  2,  2,  0,  0,  2,  0,  0,  0,  0,  0,  2,  4,  0 ],
		[  0,  0,  2,  2,  0,  2,  2,  2,  2,  2,  0,  2,  0 ],
		[  1,  1,  0,  0,  2,  2,  0,  2,  0,  2,  2,  4,  0 ],
		[  1,  3,  0,  0,  2,  0,  2,  0,  2,  0,  0,  0,  0 ],
		[  0,  8,  1,  0,  2,  2,  2,  2,  2,  0,  0,  3,  1 ],
		[  0,  0,  4,  1,  0,  0,  0,  0,  0,  1,  1,  0,  0 ],
		[  0,  3,  8,  0,  1,  7,  1,  7,  1,  0,  1,  5,  1 ],
		[  1,  0,  0,  0,  4,  1, 10,  1,  4,  0,  0,  1, 32 ],
		[  0,  0,  0,  0,  0,  0,  1,  0,  0,  0,  0,  0,  0 ]
	]
}