{
	"name": "green_honey",
	"par": 103,
	"start": [ 11, 2 ],
	"grid": [
		[  0,  0,  0,  0,  0,  0,  0,  0,  0,  0,  0,  2,  0 ],
		[  0,  0,  0,  0,  0,  0,  0,  0,  2,  2,  2,  4,  0 ],
		[  0,  0,  0,  0,  0,  0,  2,  2,  0,  0,  0,  2,  0 ],
		[  0,  0,  0,  0,  0,  2,  0,  0,  2,  2,  2,  4,  0 ],
		[  0,  0,  2,  2,  2,  0,  2,  2,  0,  2,  0,  0,  1 ],
		[  0,  2,  0,  0,  0,  2,  0,  2,  2,  0,  0,  3,  0 ],
		[  2,  2,  2,  2,  2,  2,  2,  0,  2,  0,  1,  0,  1 ],
		[  0,  0,  0,  0,  2,  0,  2,  2,  0,  1,  1,  5, 32 ],
		[  1,  1,  0,  0,  2,  2,  0,  0,  1,  0,  0,  1,  0 ],
		[  1,  3,  1,  0,  0,  0,  1,  7,  4,  0,  0,  0,  0 ],
		[  0,  8,  4,  1,  1,  7, 10,  1,  0,  0,  0,  0,  0 ],
		[  0,  0,  8,  0,  4,  1,  1,  0,  0,  0,  0,  0,  0 ],
		[  0,  3,  0,  0,  0,  0,  0,  0,  0,  0,  0,  0,  0 ],
		[  1,  0,  0,  0,  0,  0,  0,  0,  0,  0,  0,  0,  0 ]
	]
}