{
	"name": "carefully_does_it",
	"par": 69,
	"start": [ 0, 12 ],
	"grid": [
		[  0,  0,  0,  0,  0,  0,  0,  0,  0,  0,  0,  0,  0,  2 ],
		[  0,  0,  0,  0,  0,  0,  0,  0,  0,  0,  0,  0,  2,  1 ],
		[  0,  0,  0,  0,  0,  0,  0,  0,  0,  0,  0, 36,  2,  2 ],
		[  0,  0,  0,  0,  0,  0,  0,  0,  0,  0,  2,  0,  2,  1 ],
		[  0,  0,  0,  0,  0,  0,  0,  0,  0,  1,  2, 36,  2,  2 ],
		[  0,  0,  0,  0,  0,  0,  0,  1,  1,  0,  0,  0,  0,  0 ],
		[  0,  0,  3,  3,  0,  1,  1,  0,  3,  0,  0,  0,  0,  0 ],
		[  0,  3,  9,  0,  1,  0, 10,  0,  1,  1,  0,  0,  0,  0 ],
		[  0,  0,  2, 10,  0,  0,  1,  1,  0,  1,  0,  0,  0,  0 ],
		[  9,  2,  5,  9,  0,  1,  0,  0,  1,  0,  0,  0,  0,  0 ],
		[  3,  2,  2,  0,  4,  0,  4,  1,  0,  0,  0,  0,  0,  0 ],
		[  9,  0,  0,  1,  1,  0,  0,  0,  0,  0,  0,  0,  0,  0 ],
		[  1,  0,  1,  1,  1,  0,  0,  0,  0,  0,  0,  0,  0,  0 ],
		[  0,  0,  9,  1,  0,  0,  0,  0,  0,  0,  0,  0,  0,  0 ],
		[  0,  0,  1,  0,  0,  0,  0,  0,  0,  0,  0,  0,  0,  0 ]
	]
}