{
	"name": "radioactive_ice",
	"par": 103,
	"start": [ 4, 5 ],
	"grid": [
		[  0,  0,  0,  0,  0,  0,  0,  0,  0,  0,  0,  2,  0 ],
		[  0,  0,  0,  1,  0,  0,  0,  0,  0,  2,  0, 10,  0 ],
		[  0,  1,  1,  1,  0,  0,  0,  2,  0, 10, 10, 10,  0 ],
		[  1,  1, 41,  1,  0,  0,  0,  7, 10,  4, 10, 10,  2 ],
		[  0,  0,  1,  1,  0,  1,  1,  7, 10, 10, 10, 10,  0 ],
		[  0,  0,  0,  1,  1,  1, 41,  7, 10, 10, 10, 10,  2 ],
		[  0,  1,  1,  1,  0,  0,  1,  7, 10,  4, 10, 10,  0 ],
		[  1,  1, 41,  1,  0,  0,  0,  2, 10, 10, 10, 10,  2 ],
		[  0,  0,  1,  1,  0,  0,  0,  0,  0,  2, 10, 10,  0 ],
		[  0,  0,  0,  0,  0,  0,  0,  0,  0,  0,  0,  2,  0 ]
	]
}