{
	"name": "pro_skater",
	"par": 62,
	"start": [ 0, 9 ],
	"grid": [
		[  0,  0,  0,  0,  0,  0,  0,  0,  0,  0,  0,  0,  2 ],
		[  0,  0,  0,  0,  0,  0,  0,  0,  0,  0,  0,  0,  7 ],
		[  0,  0,  0,  0,  0,  0,  0,  0,  0,  0,  4,  0,  2 ],
		[  0,  0,  0,  0,  0,  0,  0, 10, 10, 10, 10,  7,  7 ],
		[  0,  0,  0,  0,  0,  0, 10,  2, 10,  2, 10,  7,  7 ],
		[  0,  0,  0,  0,  0,  0, 10, 10, 34,  2, 10,  0,  7 ],
		[  0,  0, 10, 10, 10, 10,  2, 10, 10, 10,  4,  0,  2 ],
		[  0, 10,  2, 10,  2, 10, 10,  2, 10,  0,  0,  0,  0 ],
		[  0, 10, 10, 10, 10,  0, 10, 10,  0,  0,  0,  0,  0 ],
		[  1, 10,  2, 10,  0,  0,  0,  0,  0,  0,  0,  0,  0 ],
		[  0, 10, 10,  0,  0,  0,  0,  0,  0,  0,  0,  0,  0 ]
	]
}