{
	"par": 134,
	"start": [ 0, 5 ],
	"grid": [
		[  0,  0,  3,  0,  0,  1,  0,  1,  0,  0,  0,  0 ],
		[  0,  3,  3,  0,  4,  1,  5,  0,  0,  0,  0,  0 ],
		[ 10,  0,  0,  0,  9,  5,  1,  6,  0,  0,  0,  0 ],
		[  3,  0,  0,  0,  1,  4,  1,  0,  4,  8,  0,  0 ],
		[  3,  1,  0, 10,  1,  0,  0,  0,  0,  2,  0,  0 ],
		[  1,  1,  0,  5, 10,  0,  0,  0,  0,  2,  7,  7 ],
		[  1,  0, 10, 10,  0,  0,  0,  0,  0, 34,  2,  7 ],
		[  1,  9,  0,  0,  1,  9,  1,  9,  0,  2,  2,  7 ],
		[  1,  1,  0,  1,  1,  1,  5,  1, 34,  2,  7,  0 ],
		[  0,  0,  1,  0,  0,  0,  9,  0,  2,  0,  0,  0 ]
	]
}