{
	"name": "spinners",
	"par": 80,
	"start": [ 0, 6 ],
	"grid": [
		[  0,  0,  3,  0,  4,  2,  2,  0,  4,  8,  0,  0 ],
		[  0,  0,  3,  0,  2,  5,  1,  0,  0,  2,  7,  7 ],
		[  0,  3,  0,  0,  1,  4,  0,  0,  0,  2,  2,  7 ],
		[  3,  0,  0,  0,  1,  0,  0,  0,  0,  2,  2,  7 ],
		[  3,  0,  0, 10, 10,  0,  0,  0,  0,  2,  7,  0 ],
		[  3,  1,  0,  5,  0,  0,  1,  9, 34,  2,  0,  0 ],
		[  1,  1, 10, 10,  1,  9,  5,  1,  2,  0,  0,  0 ],
		[  1,  0,  0,  0,  1,  1,  9,  0,  0,  0,  0,  0 ],
		[  1,  9,  0,  1,  0,  0,  0,  0,  0,  0,  0,  0 ],
		[  1,  1,  1,  0,  0,  0,  0,  0,  0,  0,  0,  0 ]
	]
}