{
	"name": "deslippify",
	"par": 107,
	"start": [ 0, 4 ],
	"grid": [
		[  0,  0,  0,  0,  0,  0,  0,  2,  0,  0,  0,  0,  0 ],
		[  0,  0,  0,  0,  0,  0,  2,  2,  0,  0,  0,  0,  0 ],
		[  0,  0,  0,  0,  0,  2,  2,  2,  0,  0,  0, 33, 33 ],
		[  0,  0,  0,  0,  1,  1, 10, 10,  4,  0, 10,  1,  1 ],
		[  1,  0,  0, 10,  0,  2,  2,  2,  0, 10,  0, 33,  1 ],
		[  2,  0, 10,  0,  0,  2,  2,  0, 10, 10, 10, 33,  1 ],
		[  2, 10,  0,  0,  0,  2,  0,  4, 10,  4, 10,  1,  0 ],
		[  2,  0,  0,  0,  0,  0, 10,  0,  0,  0,  0,  0,  0 ],
		[  0,  0,  0,  0,  0, 42,  7,  0,  8, 33,  0,  0,  0 ],
		[  0,  0,  0,  0,  0,  1,  8,  8,  0,  0,  0,  0,  0 ],
		[  2, 10,  2,  1,  8,  0,  0,  0,  0,  0,  0,  0,  0 ]
	]
}