{
	"par": 128,
	"start": [ 0, 4 ],
	"grid": [
		[  2, 10,  0,  0,  0,  0,  0,  0,  0,  0,  0,  0,  0 ],
		[ 10,  0, 10, 10,  0,  0,  0,  0,  0,  0,  0,  3,  0 ],
		[ 10,  0,  0,  2,  7,  7,  0,  0,  0,  0,  0, 10,  1 ],
		[ 10, 39,  2,  0,  2,  0,  7,  7,  0,  2,  1, 10,  0 ],
		[  7,  7,  0,  0, 10,  0,  0,  7,  2,  2,  0, 10,  0 ],
		[  7,  0,  2, 10,  2,  7,  7,  0,  0,  0,  2, 10,  0 ],
		[  2,  0,  0,  2,  7,  0,  0,  0,  0,  0,  0,  3,  1 ],
		[  2,  2,  2,  0,  0,  0,  0,  0,  0,  0,  0,  0,  0 ],
		[  2,  0,  0,  0,  0,  0,  0,  0,  0,  0,  0,  0,  0 ]
	]
}