{
	"name": "tri_mesh",
	"par": 128,
	"start": [ 0, 8 ],
	"grid": [
		[  0,  0,  0,  0,  0,  0,  0,  0,  0,  0,  0,  3,  1 ],
		[  0,  0,  0,  0,  0,  0,  0,  0,  0,  0,  0, 10,  0 ],
		[  0,  0,  0,  0,  0,  0,  0,  0,  0,  0,  1, 10,  0 ],
		[  0,  0,  0,  0,  0,  0,  0,  0,  0,  2,  0, 10,  0 ],
		[  2, 10, 10, 10,  7,  7,  7,  7,  2,  2,  2, 10,  1 ],
		[ 10,  0,  0,  2,  2,  0,  0,  7,  0,  0,  0,  3,  0 ],
		[ 10,  0,  2,  0, 10,  0,  7,  0,  0,  0,  0,  0,  0 ],
		[ 10, 39,  0,  0,  2,  7,  0,  0,  0,  0,  0,  0,  0 ],
		[  7,  7,  2, 10,  7,  0,  0,  0,  0,  0,  0,  0,  0 ],
		[  7,  0,  0,  2,  0,  0,  0,  0,  0,  0,  0,  0,  0 ],
		[  2,  0,  2,  0,  0,  0,  0,  0,  0,  0,  0,  0,  0 ],
		[  2,  2,  0,  0,  0,  0,  0,  0,  0,  0,  0,  0,  0 ],
		[  2,  0,  0,  0,  0,  0,  0,  0,  0,  0,  0,  0,  0 ]
	]
}