{
	"name": "finishing_strike",
	"par": 125,
	"start": [ 0, 7 ],
	"grid": [
		[  0,  0,  0,  0,  0,  0,  2,  2,  2,  2,  2 ],
		[  0,  0,  0,  0,  2,  2,  9,  0,  0,  9,  2 ],
		[  0,  0,  0,  2,  2,  0,  7,  7,  2,  0,  2 ],
		[  0,  0,  0,  2,  0,  7,  7,  0,  7,  0,  2 ],
		[  0,  0,  2,  9,  7,  0, 73,  0,  7,  9,  2 ],
		[  0,  0,  2,  0,  2,  2,  2,  0,  2,  0,  2 ],
		[  0, 66,  2,  0,  7,  7,  2,  7,  0,  2,  0 ],
		[  2,  0,  2,  0,  0,  0,  2,  0,  2,  0,  0 ],
		[  0,  0,  2,  2,  2,  2,  2,  2,  0,  0,  0 ],
		[  3,  9,  0,  0,  2,  7,  9,  0,  0,  0,  0 ],
		[  3,  3,  0,  0,  0,  0,  0,  0,  0,  0,  0 ]
	]
}