{
	"name": "big_jumps",
	"par": 105,
	"start": [ 1, 9 ],
	"grid": [
		[  0,  0,  0,  0,  0,  0,  0,  0,  2,  2,  0,  0 ],
		[  0,  0,  0,  0,  0,  0,  0,  2,  0,  7,  2,  2 ],
		[  0,  0,  0,  0,  0,  0,  2,  0,  2,  0,  7,  2 ],
		[  0,  0,  0,  0,  0,  2,  0,  2,  0,  7,  0,  2 ],
		[  0,  0,  0,  0,  2,  0,  0,  2,  7,  0,  2,  0 ],
		[  0,  0,  0,  2,  0,  0,  0,  2,  2,  1,  0,  0 ],
		[  0,  0,  2,  0,  0,  0,  0,  0,  0,  0,  2,  0 ],
		[  0, 71,  0,  0,  0,  0,  0,  1,  2,  5,  0,  0 ],
		[  2,  7,  0,  0,  0,  0,  0,  0,  0,  2,  0,  0 ],
		[  2,  1,  0,  0,  0, 69,  2,  0,  0,  0,  0,  0 ],
		[  0,  2,  0,  0,  2,  2,  0,  0,  0,  0,  0,  0 ],
		[  2, 69,  2, 65,  0,  0,  0,  0,  0,  0,  0,  0 ],
		[  2,  2,  0,  0,  0,  0,  0,  0,  0,  0,  0,  0 ]
	]
}