{
	"par": 105,
	"start": [ 1, 5 ],
	"grid": [
		[  0,  0,  0,  0,  0,  0,  0,  2,  2,  2,  0,  0 ],
		[  0,  0,  0,  0,  0,  2,  2,  0,  0,  7,  0,  0 ],
		[  0,  0,  0,  2,  2,  0,  0,  2,  2,  0,  2,  2 ],
		[  0, 71,  2,  0,  0,  0,  0,  2,  0,  7,  7,  2 ],
		[  2,  7,  0,  0,  0,  0,  0,  2,  7,  0,  0,  2 ],
		[  2,  1,  0,  0,  0,  0,  0,  0,  2,  1,  2,  0 ],
		[  0,  2,  0,  0,  0,  0,  0,  1,  0,  0,  0,  0 ],
		[  2, 69,  0,  0,  0, 69,  0,  0,  2,  5,  2,  0 ],
		[  2,  2,  2, 65,  2,  2,  2,  0,  0,  2,  0,  0 ]
	]
}