{
	"name": "wave_cannon",
	"par": 241,
	"start": [ 1, 4 ],
	"grid": [
		[  0,  2,  2,  2,  0,  0,  0,  0,  0,  0,  0, 71,  0,  0 ],
		[  0,  2,  9,  2,  0,  0,  0, 71,  0,  0,  7,  0, 71,  0 ],
		[  0,  0,  2,  0,  0,  0,  0,  7,  0,  7,  7,  7,  0,  0 ],
		[  0,  0, 66,  0,  0,  0,  0,  7,  7,  7,  0,  7,  0,  0 ],
		[  0,  2,  2,  2,  2,  2,  7,  0,  0,  0,  7,  0,  7,  0 ],
		[  0,  9,  0,  9,  0,  4,  2,  0, 71,  7,  0,  0,  7,  0 ],
		[  9,  0,  9,  2,  9,  0,  7,  7,  0,  7, 71,  0,  7,  7 ],
		[  9,  9,  5,  9,  9,  0,  0,  0,  7,  7,  0,  7,  0,  7 ],
		[  9,  9,  0,  9,  9,  0,  0,  0,  0,  0,  7,  0,  7, 71 ],
		[  0,  0,  9,  0,  0,  0,  0,  0,  0,  0,  0,  0,  0,  0 ]
	]
}