{
	"name": "forced_fire",
	"par": 120,
	"start": [ 7, 8 ],
	"grid": [
		[  0,  0,  0,  0,  0,  0,  0,  0,  0,  0,  1,  0 ],
		[  0,  0,  0,  0,  1,  1,  0,  3,  3,  1, 14,  0 ],
		[  0,  0,  0,  1,  1,  3,  3,  3,  1,  1,  0,  0 ],
		[  0,  0,  1,  1,  0,  3,  3,  1,  1,  0,  1,  0 ],
		[  0,  0,  0,  0,  0,  0,  1,  1,  0,  5,  4,  0 ],
		[  0,  0,  9,  9,  4,  0,  4,  1,  1,  1,  2,  2 ],
		[  0,  9,  9,  9,  9,  0,  1,  1,  1,  1,  2,  2 ],
		[  9,  9,  5,  9,  9,  0,  2,  5,  1,  2,  2,  0 ],
		[  9,  9,  4,  9,  9,  0,  2,  1,  2,  2,  0,  0 ],
		[  9,  9,  4,  0,  0,  1,  1,  2,  2,  0,  0,  0 ],
		[  9,  0,  7,  2,  2,  0,  1,  2,  0,  0,  0,  0 ],
		[  0,  2,  0,  0,  0,  1,  0,  0,  0,  0,  0,  0 ],
		[  0,  2,  2,  1,  1,  0,  0,  0,  0,  0,  0,  0 ]
	]
}