{
	"name": "no_swimming_allowed",
	"par": 42,
	"start": [ 0, 12 ],
	"grid": [
		[  0,  0,  0,  0,  0,  0,  0,  0,  0,  0,  2,  2 ],
		[  0,  0,  0,  0,  0,  0,  0,  2,  2,  2,  2,  2 ],
		[  0,  0,  0,  0,  0,  0,  0,  2,  4,  2,  2,  0 ],
		[  0,  0,  0,  0,  0,  0,  0,  0,  0,  0,  5,  2 ],
		[  0,  0,  1,  0,  0,  4,  2,  4,  0,  2, 14,  0 ],
		[  0,  1,  0,  0,  0,  2,  2,  2,  0,  0,  0,  0 ],
		[  0,  0,  0,  1,  0,  2,  2,  4,  0,  0,  0,  0 ],
		[  0,  0,  0,  1,  0,  4,  0,  0,  4,  0,  0,  0 ],
		[  1, 14,  0,  1,  0,  0,  4,  2,  2,  0,  0,  0 ],
		[  1,  0,  0,  1,  0,  0,  2,  2,  0,  0,  0,  0 ],
		[  1, 14,  0,  1,  0,  0,  0,  0,  0,  0,  0,  0 ],
		[  1,  0,  0,  1,  0,  0,  0,  0,  0,  0,  0,  0 ],
		[  1, 10, 10,  1,  0,  0,  0,  0,  0,  0,  0,  0 ]
	]
}