{
	"name": "no_swimming_allowed",
	"par": 42,
	"start": [ 0, 8 ],
	"grid": [
		[  0,  0,  0,  0,  0,  0,  0,  2,  0,  0,  0,  0 ],
		[  0,  1,  1,  0,  0,  0,  0,  2,  2,  2,  2,  2 ],
		[  0,  0,  0,  0,  0,  4,  0,  0,  4,  2,  2,  2 ],
		[  0,  0,  0,  1,  0,  2,  2,  4,  0,  0,  2,  0 ],
		[  1, 14,  0,  1,  0,  2,  2,  2,  0,  2,  5,  2 ],
		[  1,  0,  0,  1,  0,  4,  2,  4,  0,  0, 14,  0 ],
		[  1, 14,  0,  1,  0,  0,  0,  0,  0,  0,  0,  0 ],
		[  1,  0,  0,  1,  0,  0,  4,  2,  4,  0,  0,  0 ],
		[  1, 10,  0,  1,  0,  0,  2,  2,  2,  0,  0,  0 ],
		[  0,  0, 10,  1,  0,  0,  0,  0,  0,  0,  0,  0 ]
	]
}