{
	"name": "more_lifting",
	"par": 37,
	"start": [ 6, 8 ],
	"grid": [
		[  0,  0,  0,  0,  0,  2,  2 ],
		[  0,  2,  2,  0,  2,  0,  2 ],
		[  2,  0,  2,  0,  6,  2,  2 ],
		[  2,  0,  2, 15,  0,  0,  2 ],
		[  2, 15, 15,  0,  0,  1,  0 ],
		[  1,  0,  2,  0,  0,  1,  0 ],
		[  1,  0,  0,  1,  1,  0,  0 ],
		[  1,  1,  1,  2,  2,  2,  0 ],
		[  0,  0,  2,  2, 16, 15,  1 ],
		[  0,  0,  0,  2,  2,  0,  0 ]
	]
}