{
	"name": "house",
	"par": 23,
	"start": [ 1, 16 ],
	"grid": [
		[  0,  0,  0,  0,  0,  0,  0,  0,  0,  0,  0,  1,  1 ],
		[  0,  0,  0,  0,  0,  0,  0,  0,  0,  0,  0,  1,  0 ],
		[  0,  0,  0,  0,  0,  0,  0,  0,  1,  1,  0,  0,  0 ],
		[  0,  0,  0,  0,  0,  0,  0,  1,  1,  0,  0,  0,  0 ],
		[  0,  0,  0,  0,  0,  0,  0,  1,  0,  0,  0,  0,  0 ],
		[  0,  0,  0,  0,  0,  0,  0,  0,  0,  0,  0,  0,  0 ],
		[  0,  0,  0,  0,  0,  4,  4, 16,  4,  4,  0,  0,  0 ],
		[  0,  0,  0,  0,  4,  4,  4,  4,  4,  4,  0,  0,  0 ],
		[  0,  0,  0,  4,  4,  4,  4,  2,  2,  0,  0,  0,  0 ],
		[  0,  0,  4,  4,  4,  2,  2, 10,  2,  0,  0,  0,  0 ],
		[  0,  4,  4,  2,  2, 10,  2, 10,  2,  0,  0, 10, 10 ],
		[  0,  4,  2,  2,  2, 10,  2,  2,  2, 10, 10,  0,  0 ],
		[  0,  0,  2,  9,  2,  2,  2, 10, 10, 10,  0,  0,  0 ],
		[  0,  0,  2,  9,  2, 10, 10, 10,  0,  0,  0,  0,  0 ],
		[  0,  0,  2, 10, 10, 10,  0,  0,  0,  0,  0,  0,  0 ],
		[  0, 10, 10, 10,  0,  0,  0,  0,  0,  0,  0,  0,  0 ],
		[ 10, 10,  0,  0,  0,  0,  0,  0,  0,  0,  0,  0,  0 ]
	]
}