{
	"name": "hunting",
	"par": 52,
	"start": [ 0, 9 ],
	"grid": [
		[  0,  0,  0,  0,  0, 10, 10, 10,  0,  0,  0,  0,  0 ],
		[  0,  0, 10, 10, 10,  0,  0, 10, 10,  0,  0,  0,  0 ],
		[  0,  0,  0, 10,  0, 10, 10,  0,  9,  3,  0,  0,  0 ],
		[  0,  0,  0,  0, 10,  0,  0,  3,  3,  3,  3,  3,  0 ],
		[  0,  0,  0,  0,  0,  0,  0, 16,  4,  3,  3,  3,  0 ],
		[  0,  3,  3,  3,  0,  0,  9,  3, 16,  3,  3,  3,  0 ],
		[  0,  3,  0, 15,  0,  3,  3,  9, 16,  3,  3,  9,  0 ],
		[  0,  0, 15,  2, 15,  0,  0,  0,  0,  0, 10, 10, 10 ],
		[  0,  1, 15, 15, 15,  3,  0,  0, 10,  0, 10, 10, 10 ],
		[  1,  0,  0,  3,  0,  3,  0,  0,  0,  0, 10, 10, 10 ],
		[  0,  0,  0,  0,  3,  0,  0,  0, 10, 10, 10,  0,  0 ]
	]
}