{
	"name": "opportunist",
	"par": 43,
	"start": [ 2, 5 ],
	"grid": [
		[  0,  0,  0,  2,  2,  0,  0,  0 ],
		[  3,  2,  2,  9,  4,  0,  6,  6 ],
		[  0,  0,  1,  2, 15,  0,  6,  6 ],
		[  0,  1,  2,  2, 15,  0,  6,  0 ],
		[  1, 66,  3,  3,  2,  0,  0,  0 ],
		[  1,  1,  1,  1,  0,  0,  0,  0 ]
	]
}