{
	"name": "opportunist",
	"par": 43,
	"start": [ 2, 5 ],
	"grid": [
		[  3,  2,  0,  2,  0,  0,  0,  0 ],
		[  0,  0,  2,  9,  2,  0,  0,  0 ],
		[  0,  1,  1,  2,  4,  0,  0,  0 ],
		[  1, 66,  2,  2, 15,  0,  6,  6 ],
		[  1,  1,  3,  3, 15,  0,  6,  6 ],
		[  0,  0,  1,  1,  2,  0,  6,  0 ]
	]
}