{
	"name": "demolition",
	"par": 83,
	"start": [ 0, 4 ],
	"grid": [
		[  0,  0,  0,  7,  7,  7,  0,  0,  0,  0,  0,  0 ],
		[  0,  0,  0,  7,  7,  7,  0,  0,  0,  0,  0,  0 ],
		[  0,  0,  0,  0,  7,  0,  0,  0,  0,  0,  0,  0 ],
		[  0,  0,  0,  3,  3,  3,  0,  0,  0,  3,  3,  3 ],
		[  2,  0, 15,  0,  3,  0,  3,  8,  8,  8,  3,  3 ],
		[  2,  2,  2,  2,  0,  2,  1,  8,  8,  8,  0,  1 ],
		[  2,  2,  2,  3,  2,  3,  0,  0,  8,  1,  0,  3 ],
		[  1,  0,  0,  0,  3,  0,  3,  3,  3,  0,  3,  3 ]
	]
}