{
	"name": "upper",
	"par": 51,
	"start": [ 0, 4 ],
	"grid": [
		[  0,  0,  0,  2,  0,  0,  0,  0,  0,  2,  2,  2,  0 ],
		[  0,  0,  0,  1,  0,  0,  0,  0,  0,  2,  8,  2,  0 ],
		[  0,  0,  0, 16,  0,  2,  2,  0,  0,  0,  1,  0,  0 ],
		[  7,  0,  0, 15,  4,  2,  2,  0,  0,  0,  4,  0,  0 ],
		[  1,  1,  0,  1,  0,  0,  2,  0,  0,  2, 15,  2,  0 ],
		[  0,  0,  1,  1, 73,  0,  0,  2,  2,  0,  2,  0,  2 ],
		[  0,  2, 15,  2,  1,  1,  0, 15,  0,  2,  0,  2,  2 ],
		[  0,  2, 15,  2,  0,  0,  1,  1, 15,  0,  2,  0,  0 ],
		[  0,  0,  3,  0,  0,  0,  0,  0,  1,  0,  0,  0,  0 ]
	]
}