{
	"name": "upper",
	"par": 51,
	"start": [ 0, 9 ],
	"grid": [
		[  0,  0,  0,  0,  0,  0,  0,  0,  0,  0,  2,  2,  0 ],
		[  0,  0,  0,  0,  0,  0,  0,  0,  0,  2,  8,  2,  0 ],
		[  0,  0,  0,  0,  0,  0,  0,  0,  0,  2,  1,  0,  0 ],
		[  0,  0,  0,  0,  0,  0,  0,  0,  0,  0,  4,  0,  0 ],
		[  0,  0,  0,  2,  0,  0,  2,  0,  0,  0, 15,  2,  2 ],
		[  0,  0,  0,  1,  0,  2,  2,  0,  0,  2,  2,  0,  2 ],
		[  0,  0,  0, 16,  4,  2,  2,  0,  2,  0,  0,  2,  0 ],
		[  0,  0,  0, 15,  0,  0,  0,  2,  0,  2,  2,  0,  0 ],
		[  7,  0,  0,  1, 73,  0,  0, 15, 15,  0,  0,  0,  0 ],
		[  1,  1,  1,  1,  1,  1,  1,  1,  1,  0,  0,  0,  0 ],
		[  0,  0, 15,  2,  0,  0,  0,  0,  0,  0,  0,  0,  0 ],
		[  0,  2, 15,  2,  0,  0,  0,  0,  0,  0,  0,  0,  0 ],
		[  0,  2,  3,  0,  0,  0,  0,  0,  0,  0,  0,  0,  0 ]
	]
}