{
	"name": "somewhat_constructive",
	"par": 38,
	"start": [ 0, 4 ],
	"grid": [
		[  0,  0,  0,  1,  1,  1,  1,  1, 12,  0,  0,  0, 15 ],
		[  0,  0,  0,  0,  0, 12,  0,  0,  0,  0,  0, 15,  2 ],
		[  0,  0,  0, 12,  0,  0, 12,  0,  0,  3, 15,  2,  0 ],
		[  0,  0,  0,  1,  0,  0,  1,  1, 15,  3,  0,  0,  0 ],
		[  1,  1,  1,  0,  0,  0,  0,  1,  0,  0,  0,  0,  0 ],
		[  0,  0,  0,  0,  0,  2,  2,  0,  0,  0,  0,  0,  0 ],
		[  0,  0,  0,  0,  1,  0,  0,  0,  0,  0,  0,  0,  0 ]
	]
}