{
	"par": 38,
	"start": [ 0, 3 ],
	"grid": [
		[  0,  0,  0,  1,  0,  0,  0,  0,  0,  0,  0,  0,  0 ],
		[  0,  0,  0,  0,  1,  1,  0,  0,  0,  0,  0,  0,  0 ],
		[  0,  0,  0, 12,  0, 12,  1,  1,  0,  0,  0,  0,  0 ],
		[  1,  1,  0,  1,  0,  0,  0,  0, 12,  0,  0,  0,  0 ],
		[  0,  0,  1,  0,  0,  0, 12,  0,  0,  0,  0,  0,  0 ],
		[  0,  0,  0,  0,  0,  0,  1,  1,  0,  3,  0, 15, 15 ],
		[  0,  0,  0,  0,  0,  2,  0,  1, 15,  3, 15,  2,  2 ],
		[  0,  0,  0,  0,  1,  0,  2,  0,  0,  0,  0,  0,  0 ]
	]
}