{
	"name": "overbuild",
	"par": 45,
	"start": [ 4, 9 ],
	"grid": [
		[  0,  0,  0,  0,  0,  0,  0,  0,  0,  0,  0,  4 ],
		[  0,  0,  0,  0,  0,  0,  0,  0,  0, 65,  1,  0 ],
		[  0,  0,  0,  0,  1,  1,  0,  4,  1,  1,  0,  5 ],
		[  1,  3,  3, 15,  1,  0,  0,  0,  0,  1,  1,  0 ],
		[  1,  3,  3,  0,  3,  0,  0,  5,  1,  4,  0,  0 ],
		[  1,  3,  0,  0,  3,  0,  0,  0,  0, 12,  0,  0 ],
		[  1,  0,  0,  0,  3,  2,  0,  0,  0,  0,  0,  0 ],
		[  0,  0,  0,  2, 12,  2,  0,  0,  0,  4,  0,  0 ],
		[  0,  0,  0,  2,  2,  0,  2, 12,  0,  1,  0,  0 ],
		[  0,  0,  0,  0,  1,  2,  5,  2,  1,  0,  0,  0 ],
		[  0,  0,  0,  0,  0,  2,  2,  0,  0,  0,  0,  0 ]
	]
}