{
	"par": 45,
	"start": [ 4, 8 ],
	"grid": [
		[  1,  3,  0,  0,  0,  0,  0,  0,  0,  0,  0,  0 ],
		[  1,  3,  3, 15,  1,  1,  0,  0,  0,  0,  0,  0 ],
		[  1,  3,  3,  0,  1,  0,  0,  4,  0, 65,  0,  4 ],
		[  1,  0,  0,  0,  3,  0,  0,  0,  1,  1,  1,  0 ],
		[  0,  0,  0,  0,  3,  0,  0,  5,  0,  1,  0,  5 ],
		[  0,  0,  0,  2,  3,  2,  0,  0,  1,  4,  1,  0 ],
		[  0,  0,  0,  2, 12,  2,  0,  0,  0, 12,  0,  0 ],
		[  0,  0,  0,  0,  2,  0,  0,  0,  0,  0,  0,  0 ],
		[  0,  0,  0,  0,  1,  2,  2, 12,  0,  4,  0,  0 ],
		[  0,  0,  0,  0,  0,  2,  5,  2,  0,  1,  0,  0 ],
		[  0,  0,  0,  0,  0,  0,  2,  0,  1,  0,  0,  0 ]
	]
}