{
	"name": "reversing_space",
	"par": 135,
	"start": [ 0, 6 ],
	"grid": [
		[  0,  6,  6,  6,  0,  2,  2,  2,  0 ],
		[  0,  7, 12,  7,  0,  2,  2,  2,  0 ],
		[  0,  0,  7,  0,  0,  0,  7,  0,  0 ],
		[  0,  2,  7,  2,  0,  2,  7,  2,  0 ],
		[  7,  0,  0,  0,  7,  0,  0,  0,  7 ],
		[  7,  0,  0,  7,  7,  7,  0,  0,  7 ],
		[  1,  0,  0,  7,  5,  7,  0,  0,  1 ],
		[  0,  0,  0,  0,  7,  0,  0,  0,  0 ]
	]
}