{
	"name": "a_little_light_lifting",
	"par": 39,
	"start": [ 1, 3 ],
	"grid": [
		[  0,  0,  0,  0,  0,  2,  2,  2,  2 ],
		[  0,  0,  0,  2,  2,  0,  0,  2,  2 ],
		[  0,  0,  2,  2,  0,  0,  0,  2,  0 ],
		[  0,  2,  0,  2,  0,  3,  2,  2,  0 ],
		[  0,  2,  2, 15,  3, 15,  3,  2,  0 ],
		[  0,  2,  0,  0,  2,  3,  3,  2,  0 ],
		[  2,  0,  0,  2,  2,  2,  2,  0,  0 ],
		[  2,  0,  2,  0,  0,  0,  0,  0,  0 ],
		[  2,  2,  0,  0,  0,  0,  0,  0,  0 ],
		[  2,  0,  0,  0,  0,  0,  0,  0,  0 ]
	]
}