{
	"par": 39,
	"start": [ 1, 1 ],
	"grid": [
		[  0,  0,  0,  2,  0,  2,  0,  0,  0 ],
		[  0,  2,  2,  2,  2,  0,  2,  2,  0 ],
		[  0,  2,  0,  2,  0,  0,  0,  2,  2 ],
		[  0,  2,  2, 15,  0,  3,  0,  2,  2 ],
		[  2,  0,  0,  0,  3, 15,  2,  2,  0 ],
		[  2,  0,  0,  2,  2,  3,  3,  2,  0 ],
		[  2,  2,  2,  0,  2,  2,  3,  2,  0 ],
		[  2,  0,  0,  0,  0,  0,  2,  0,  0 ]
	]
}