{
	"name": "beware_feedback_loops",
	"par": 50,
	"start": [ 2, 8 ],
	"grid": [
		[  0,  0,  0,  0,  0,  0,  0,  0, 10, 10,  0,  0,  0 ],
		[  0,  0,  0,  0,  0,  0,  0,  0,  0,  0,  0,  0,  0 ],
		[  0,  0,  0,  0,  0,  0,  0,  0,  0, 10,  0,  0, 10 ],
		[  0,  0,  0,  0,  0,  0,  0,  0,  0,  0,  0,  0,  0 ],
		[  0,  0,  0,  0,  0,  0,  0,  0,  0,  0,  0,  0,  0 ],
		[  0,  0,  0,  0,  0,  0,  0,  0,  0,  0,  0,  0,  0 ],
		[  0,  0,  0,  1,  1, 10,  1,  2,  0,  0,  0,  0,  0 ],
		[  0,  0,  0,  1,  0,  0,  2,  2,  0,  0,  0,  0, 10 ],
		[ 10,  0,  1,  0,  0,  0,  2,  2,  2,  2, 12,  0,  0 ],
		[  0,  0,  1,  0,  0,  0, 12,  0, 12,  2,  0,  0,  0 ],
		[  0,  0,  2,  0,  0,  0,  2,  0,  2,  0,  0,  0,  0 ],
		[  0,  0,  9,  0,  0,  0,  0,  0,  0,  0,  0,  0,  0 ],
		[  0,  0, 10,  0,  0, 10,  0, 10,  0,  0,  0,  0,  0 ],
		[ 10, 10,  2,  0,  9,  0,  0,  0,  0,  0,  0,  0,  0 ],
		[  0,  0,  2,  2,  0,  0,  0,  0,  0,  0,  0,  0,  0 ]
	]
}