{
	"par": 50,
	"start": [ 2, 5 ],
	"grid": [
		[  0,  0,  0,  0,  0,  0,  0,  0, 10, 10,  0,  0,  0 ],
		[  0,  0,  0,  0,  0,  0,  0,  0,  0,  0,  0,  0,  0 ],
		[  0,  0,  0,  0,  0,  0,  0,  0,  0, 10,  0,  0,  0 ],
		[  0,  0,  0,  1,  0,  0,  0,  0,  0,  0,  0,  0,  0 ],
		[ 10,  0,  0,  1,  1, 10,  0,  0,  0,  0,  0,  0, 10 ],
		[  0,  0,  1,  0,  0,  0,  1,  2,  0,  0,  0,  0,  0 ],
		[  0,  0,  1,  0,  0,  0,  2,  2,  0,  0,  0,  0,  0 ],
		[  0,  0,  2,  0,  0,  0,  2,  2,  0,  0,  0,  0,  0 ],
		[  0,  0,  9,  0,  0,  0, 12,  0,  2,  2,  0,  0,  0 ],
		[ 10, 10, 10,  0,  0,  0,  2,  0, 12,  2, 12,  0, 10 ],
		[  0,  0,  2,  0,  0, 10,  0,  0,  2,  0,  0,  0,  0 ],
		[  0,  0,  2,  2,  9,  0,  0, 10,  0,  0,  0,  0,  0 ]
	]
}