{
	"name": "a_strange_place",
	"par": 90,
	"start": [ 1, 9 ],
	"grid": [
		[  0,  0,  0,  0,  0,  0,  0,  0,  0,  0,  0,  8 ],
		[  0,  0,  0,  0,  0,  0,  0,  0,  0,  2,  2,  0 ],
		[  0,  0,  0,  0,  0,  0,  0,  0,  0,  8,  2,  0 ],
		[  0,  0,  0,  0,  0,  0,  0,  0,  8,  0,  0,  0 ],
		[  0,  0,  0,  0,  0,  0,  0,  0,  0,  0,  0,  0 ],
		[  0,  2,  0,  0,  0,  0,  2,  0,  0,  0,  0,  0 ],
		[  7,  2,  8,  0,  0,  5,  0,  0,  0,  0,  0,  0 ],
		[  2,  0,  2,  0, 12,  0,  0,  0,  0, 14,  0,  0 ],
		[  1,  1,  1,  1,  0,  1,  1,  1,  1,  1,  0,  0 ],
		[  0,  1,  0,  0,  0,  0,  0,  0,  0,  0,  0,  0 ],
		[  0,  2,  2,  0,  0,  0,  0,  0,  0,  0,  0,  0 ]
	]
}