{
	"name": "a_strange_place",
	"par": 90,
	"start": [ 1, 4 ],
	"grid": [
		[  0,  2,  0,  0,  0,  0,  0,  0,  0,  2,  0,  8 ],
		[  7,  2,  0,  0,  0,  0,  0,  0,  0,  8,  2,  0 ],
		[  2,  0,  8,  0,  0,  0,  0,  0,  8,  0,  2,  0 ],
		[  1,  1,  2,  0,  0,  5,  2,  0,  0,  0,  0,  0 ],
		[  0,  1,  1,  1, 12,  0,  0,  0,  0,  0,  0,  0 ],
		[  0,  2,  0,  0,  0,  1,  0,  0,  0,  0,  0,  0 ],
		[  0,  0,  2,  0,  0,  0,  1,  1,  0, 14,  0,  0 ],
		[  0,  0,  0,  0,  0,  0,  0,  0,  1,  1,  0,  0 ]
	]
}