{
	"name": "commute",
	"par": 75,
	"start": [ 10, 3 ],
	"grid": [
		[  0,  0,  0,  0,  0,  0,  0,  0,  0,  0,  0,  3,  3 ],
		[  0,  3,  0,  0,  0,  0,  0,  0,  0,  0,  3,  3,  7 ],
		[  0,  8,  0,  0,  0,  0,  0,  0,  0,  3,  3,  3,  0 ],
		[  0, 15,  6, 15, 15, 15, 15, 15, 15, 15,  3,  0,  0 ],
		[  3,  3,  2,  2,  2,  2,  2,  2,  2,  2,  0,  0,  0 ],
		[  0,  0,  2,  2,  2,  2,  2,  2,  2,  0,  0,  0,  0 ],
		[  0,  0,  2,  0,  2,  2,  0,  2,  0,  0,  0,  0,  0 ]
	]
}