{
	"name": "bouncing_required",
	"par": 32,
	"start": [ 0, 4 ],
	"grid": [
		[  0,  0,  0,  2, 15,  4,  2,  1,  0 ],
		[  0,  0,  2,  2,  0,  4,  0,  2, 16 ],
		[  0,  2,  2,  0,  0,  4,  0,  4, 15 ],
		[  2,  2,  2,  2,  0,  4,  0,  2,  0 ],
		[  2,  2,  2, 15,  4, 16, 16,  1,  0 ],
		[  2,  2,  2,  0,  0,  4,  0,  0,  0 ],
		[  0,  2,  2,  0,  0,  0,  0,  0,  0 ],
		[  0,  0,  1,  2,  2,  2,  0,  0,  0 ]
	]
}