{
	"name": "fetch_quest",
	"par": 121,
	"start": [ 5, 8 ],
	"grid": [
		[  0,  0,  0,  0,  0,  0,  0,  0,  2,  2, 10 ],
		[  0,  0,  0,  0,  0,  0,  0,  5,  0,  0, 10 ],
		[  0,  0,  0,  0,  0,  7,  0,  0,  2, 10,  0 ],
		[  0,  0,  0,  0, 37,  2,  2,  2, 10, 37,  0 ],
		[  0,  0,  0,  0,  2,  0,  2, 10,  2,  0, 10 ],
		[  0,  0,  0,  0,  2,  0,  2,  2,  0,  0, 10 ],
		[  0,  0,  2,  2, 34,  2,  2, 41,  0,  0, 10 ],
		[  0,  2,  2,  0,  2,  2,  2,  0,  0,  2,  0 ],
		[  0,  2,  2,  2,  2,  2,  2, 37,  2,  0,  0 ],
		[ 39,  2,  2, 41,  2,  2,  2,  2,  0,  0,  0 ],
		[  2,  0,  0,  2,  0,  0,  0,  0,  0,  0,  0 ],
		[  2,  0,  2,  2,  0,  0,  0,  0,  0,  0,  0 ],
		[  2,  5,  0,  2,  0,  0,  0,  0,  0,  0,  0 ],
		[  0,  2,  2, 39,  0,  0,  0,  0,  0,  0,  0 ]
	]
}