{
	"name": "laser_surgery",
	"par": 38,
	"start": [ 0, 6 ],
	"grid": [
		[  0,  0,  0,  0,  3,  0,  0,  0,  0 ],
		[  0,  0,  0,  0,  2,  2,  2,  2,  2 ],
		[  0,  0,  0,  2, 10,  3, 10,  2,  2 ],
		[  0,  0,  2,  2,  2,  2,  2,  2,  2 ],
		[  0,  2, 10,  2,  2,  2, 10,  2,  0 ],
		[  2,  2,  3,  2,  2,  2,  2,  0,  0 ],
		[  2,  2, 10,  2, 10,  2,  0,  0,  0 ],
		[  2,  2,  2,  2,  2,  0,  0,  0,  0 ],
		[  0,  0,  0,  0,  2,  0,  0,  0,  0 ],
		[  0,  0,  0,  0,  9,  0,  0,  0,  0 ],
		[  0,  0,  0,  0, 10,  0,  0,  0,  0 ],
		[  0,  0,  0,  0,  3,  0,  0,  0,  0 ]
	]
}