{
	"name": "icy_tiles",
	"par": 34,
	"start": [ 2, 6 ],
	"grid": [
		[  0,  0,  0,  0,  2,  2,  0,  2,  2,  0 ],
		[  0,  0,  0,  2,  0,  2, 10,  0,  2,  0 ],
		[  0,  2,  4,  2, 10, 10, 10,  4,  2,  2 ],
		[  2,  0,  0,  2, 10, 10, 10,  2,  0,  2 ],
		[  2,  0,  0,  2,  0,  2,  0,  0,  2,  0 ],
		[  2,  0,  2,  0,  0,  2,  0,  2,  0,  0 ],
		[  2,  0,  1,  2,  2,  0,  2,  0,  0,  0 ],
		[  2,  2,  2,  2,  2,  2,  0,  0,  0,  0 ]
	]
}