{
	"par": 18,
	"start": [ 3, 4 ],
	"grid": [
		[  0,  0,  0,  1,  0,  0,  0 ],
		[  0,  0,  1,  2,  1,  0,  0 ],
		[  0,  0,  2,  2,  2,  0,  0 ],
		[  0,  0,  2, 10,  2,  0,  0 ],
		[  0,  2, 10,  2, 10,  2,  0 ],
		[  0,  2, 10, 10, 10,  2,  0 ],
		[  2,  0,  2,  0,  2,  0,  2 ],
		[  2, 10,  0,  0,  0, 10,  2 ],
		[  0,  0, 10,  2, 10,  0,  0 ]
	]
}