{
	"par": 33,
	"start": [ 1, 1 ],
	"grid": [
		[  0,  1,  0,  0,  0,  2,  0,  0,  0,  1,  4,  1,  0 ],
		[  1,  1,  1,  0,  4,  2,  2,  0,  0,  4,  1,  4,  0 ],
		[  1,  4,  1,  0,  2,  2,  2,  0,  0,  0,  1,  0,  0 ],
		[  0,  0,  0,  2,  0,  0,  0,  2,  4,  2,  0,  2,  0 ],
		[  0,  0,  2,  2,  2,  0,  0,  2,  2,  4,  4,  2,  2 ],
		[  0,  0,  2,  4,  4,  0,  0,  0,  2,  0,  2,  2,  2 ],
		[  0,  0,  0,  0,  0,  2,  2,  4,  0,  0,  0,  0,  0 ],
		[  0,  0,  0,  0,  0,  2,  2,  2,  0,  0,  0,  0,  0 ],
		[  0,  0,  0,  0,  0,  0,  2,  0,  0,  0,  0,  0,  0 ]
	]
}