{
	"par": 33,
	"start": [ 2, 3 ],
	"grid": [
		[  0,  0,  0,  0,  0,  0,  0,  0,  3,  3 ],
		[  0,  0,  0,  0,  0,  0,  0,  0,  3,  3 ],
		[  0,  0,  0,  1,  0,  0, 12,  0,  0,  0 ],
		[  0,  0,  1,  1, 12,  0,  0,  0,  0,  0 ],
		[  0,  0,  0,  2,  0, 14,  0,  0,  0,  0 ],
		[  0,  0,  0,  2,  2,  1,  0,  1,  0,  0 ],
		[  0,  1,  0,  0,  2,  0,  1, 12,  0,  0 ],
		[  1,  1,  1,  0,  0,  0,  1,  1,  0,  0 ]
	]
}