{
	"par": 136,
	"start": [ 7, 4 ],
	"grid": [
		[  0,  0,  3,  0,  0,  0,  0,  0,  3,  0,  0 ],
		[  0,  0,  0,  0,  0, 10,  0,  0, 10, 10,  0 ],
		[ 10, 10,  0,  0,  0, 10,  0,  2,  0, 10, 10 ],
		[ 10, 10,  0,  0,  0, 10,  2,  5,  9, 10, 10 ],
		[ 10, 10,  0,  0,  0, 10,  2,  1,  9, 10, 10 ],
		[ 10,  0,  0,  0,  0, 10,  2,  5,  9, 10, 10 ],
		[ 10,  0,  0,  0,  0,  0,  2,  2,  9, 10, 10 ],
		[ 10, 10,  0,  0,  0,  0,  0,  2,  0, 10, 10 ],
		[  0,  0,  0,  0,  0,  0,  0,  2,  0,  0,  0 ],
		[  0,  0,  0,  0,  0,  9,  0,  2,  0,  0,  0 ],
		[  0,  0,  0,  0,  9,  2,  9,  1,  0,  0,  0 ],
		[  0,  0,  0,  0,  2,  1,  1,  0,  0,  0,  0 ]
	]
}