{
	"par": 120,
	"start": [ 6, 5 ],
	"grid": [
		[  0,  7,  0,  0,  0,  0,  0,  0,  0,  0,  0,  0 ],
		[  7,  5,  7,  0,  0,  0,  2,  2,  2,  0,  0,  0 ],
		[  7,  8,  8,  2,  0,  2,  2,  2,  2,  0,  0,  0 ],
		[  8,  0,  0,  2,  2,  2,  2,  0,  2,  2,  0,  0 ],
		[  8, 15,  0,  2,  4,  2,  2,  0,  0,  9,  0,  0 ],
		[  0,  2,  5,  7,  2,  2,  1,  2,  0,  2,  0,  0 ],
		[  8,  0,  2,  2,  0,  2,  2,  1,  2,  3,  3,  3 ],
		[  8,  8,  0,  2,  2,  2,  0,  2,  4,  0,  5,  3 ],
		[  8,  8,  9,  2,  2,  4,  2,  0,  0,  0,  3,  0 ],
		[  0,  0,  0,  0,  2,  0,  0,  0,  0,  0,  0,  0 ]
	]
}