{
	"par": 23,
	"start": [ 6, 3 ],
	"grid": [
		[  1, 14,  0,  0,  0,  0,  0,  0,  0,  0,  0,  0,  1 ],
		[ 14,  0,  0,  0,  0,  0,  0,  0,  0,  0,  0,  0, 14 ],
		[  0,  0,  0,  0,  0, 14,  0, 14,  0,  0,  0,  0,  0 ],
		[  0,  0,  0,  0,  0,  4,  1,  4,  0,  0,  0,  0,  0 ],
		[  0,  0,  0,  0,  0,  2,  2,  2,  0,  0,  0,  0,  0 ],
		[  0,  0,  0,  0,  0,  2,  0,  2,  0,  0,  0,  0,  0 ],
		[  0,  0,  0,  0,  0,  0,  2,  0,  0,  0,  0,  0,  0 ],
		[  0,  0,  0,  0,  0,  0,  2,  0,  0,  0,  0,  0,  0 ],
		[  0,  0,  0,  0,  0, 14,  1, 14,  0,  0,  0,  0,  0 ],
		[  0,  0,  0,  0,  0,  0,  0,  0,  0,  0,  0,  0,  0 ],
		[ 14,  0,  0,  0,  0,  0,  0,  0,  0,  0,  0, 14, 14 ],
		[  1,  0,  0,  0,  0,  0,  0,  0,  0,  0,  0,  0,  1 ]
	]
}