{
	"par": 94,
	"start": [ 0, 3 ],
	"grid": [
		[  0,  0,  0,  0,  2,  0,  0,  0 ],
		[  1,  0,  0,  2,  2,  2,  0,  0 ],
		[  1,  2,  2,  0,  9,  0,  2,  2 ],
		[  1,  2,  9,  9,  9,  9,  9,  2 ],
		[  1,  2,  0,  9,  0,  9,  0,  2 ],
		[  1,  2,  9,  0,  9,  0,  9,  2 ],
		[  1,  2,  4,  2,  9,  2,  4,  2 ],
		[  0,  0,  2,  0,  2,  0,  2,  0 ]
	]
}