{
	"par": 218,
	"start": [ 11, 7 ],
	"grid": [
		[  0,  0,  0,  0,  0,  8,  0,  0,  0,  2,  0,  0,  0 ],
		[  0,  0,  0,  8,  8,  9,  3,  1,  1,  9,  0,  0,  0 ],
		[  0,  3,  8,  9,  3,  0,  0,  1,  1,  9,  1,  1,  0 ],
		[  1,  0,  3,  0,  0,  1,  1,  2,  0,  9,  9,  3,  0 ],
		[  1,  0,  0,  1,  1,  2,  0,  2,  0,  1,  1,  9,  3 ],
		[  1,  1,  1,  2,  0,  0,  2,  0,  0,  9,  9,  0,  3 ],
		[  7,  3,  0,  0,  2,  2,  2,  9,  0,  1,  1,  9,  0 ],
		[  3,  3,  3,  0,  2,  0,  2,  9,  0,  9,  9,  1,  0 ],
		[  3,  3,  3,  0,  2,  2,  2,  0,  0,  9,  1,  0,  0 ]
	]
}