{
	"par": 37,
	"start": [ 0, 3 ],
	"grid": [
		[  0,  0,  0,  0,  0,  2,  0,  2,  0,  0,  0,  0,  0 ],
		[  0,  1,  0,  0,  2,  5,  2,  5,  3,  0,  0,  1,  0 ],
		[  1,  1,  0,  2,  3,  3,  2,  2,  3,  2,  0,  1,  1 ],
		[  1,  1,  1,  2,  5,  2,  3,  2,  5,  2,  1,  1,  1 ],
		[  1,  1,  0,  0,  2,  5,  2,  5,  2,  0,  0,  1,  1 ],
		[  0,  0,  0,  0,  2,  2,  2,  3,  3,  0,  0,  0,  0 ]
	]
}