{
	"par": 16,
	"start": [ 1, 4 ],
	"grid": [
		[  0,  0,  0,  1,  0,  0 ],
		[  0,  1,  1,  1,  1,  1 ],
		[  0,  4,  1,  1,  1,  4 ],
		[  0,  0,  1,  1,  1,  0 ],
		[  2,  5,  2,  2,  2,  2 ],
		[  2,  2,  2,  0,  2,  0 ],
		[  2,  0,  1,  3,  0,  0 ]
	]
}