{
	"par": 46,
	"start": [ 0, 7 ],
	"grid": [
		[  0,  0,  0,  2,  0,  0,  0,  0,  0,  0,  0,  0 ],
		[  0,  2,  2,  2,  1,  2,  0,  0,  0,  0,  0,  0 ],
		[  2,  2,  2,  0,  1,  0,  2,  2,  0,  0,  0,  0 ],
		[  1,  1,  0,  0,  1,  0,  0,  1,  1,  2,  0,  0 ],
		[  2,  0,  1, 10, 10, 10,  1,  0,  2,  2,  0,  0 ],
		[  2,  0,  0, 10, 10, 10,  0,  0,  2,  2,  0,  0 ],
		[  2,  1,  1,  0, 10,  0,  1,  1,  2,  2,  0,  0 ],
		[  1,  2,  0,  0, 33,  0,  0,  2,  1,  3,  0,  3 ],
		[  2,  2,  2,  2,  1,  2,  2,  0,  0,  3, 10,  0 ],
		[  0,  0,  2,  2, 33,  0,  0,  0,  0,  0,  3,  0 ]
	]
}