{
	"par": 27,
	"start": [ 0, 4 ],
	"grid": [
		[  0,  0,  0,  0,  0,  0,  0,  2,  0,  0,  0,  0,  0 ],
		[  0,  0,  0,  0,  2,  2,  2,  2,  2,  2,  0,  0,  0 ],
		[  0,  0,  0,  0, 10, 10,  0,  2,  2,  0,  0,  0,  0 ],
		[  0, 10,  4,  0,  4,  0,  1,  1,  0,  2,  0,  0,  0 ],
		[  2, 10,  4,  0,  4,  0,  0,  1,  2,  0,  2,  2,  0 ],
		[  0,  0,  4,  0,  4,  0,  0,  1,  2,  0,  2,  2, 34 ],
		[  0,  0,  0,  0, 10, 10,  0,  1,  2,  2,  2,  0,  0 ],
		[  0,  0,  0,  0,  2,  0,  1,  0,  0,  0,  0,  0,  0 ]
	]
}