{
	"par": 107,
	"start": [ 0, 1 ],
	"grid": [
		[  0,  0,  0,  0,  0,  0,  0,  2,  0,  0,  0,  0,  0 ],
		[  1,  0,  0,  0,  0,  2,  2,  2,  0,  0,  0,  0,  0 ],
		[  2,  0,  0, 10,  1,  1,  2,  2,  0,  0,  0,  0,  0 ],
		[  2, 10, 10,  0,  0,  2, 10, 10,  0,  0,  0,  0,  0 ],
		[  2,  0,  0,  0,  0,  2,  2,  2,  4,  0,  0, 33,  0 ],
		[  0,  0,  0,  0,  0,  2,  2,  0,  0, 10, 10,  1, 33 ],
		[  0,  0,  0,  0,  0,  0,  0,  4, 10, 10,  0, 33,  1 ],
		[  2, 10,  0,  0,  0, 42, 10,  0, 10,  4, 10, 33,  1 ],
		[  0,  0,  2,  1,  0,  1,  7,  0,  0,  0, 10,  1,  1 ],
		[  0,  0,  0,  0,  8,  0,  8,  8,  8, 33,  0,  0,  0 ]
	]
}