{
	"par": 76,
	"start": [ 4, 9 ],
	"grid": [
		[  0,  0,  0,  0,  0,  0,  0,  0,  0,  2,  0,  0 ],
		[  0,  0,  0,  0,  0,  0,  0,  1,  2,  2,  2,  1 ],
		[  1,  0,  0,  0,  0,  0, 14,  0,  2,  2,  2,  4 ],
		[  2,  0,  0,  0,  0,  0,  0,  0,  0,  0,  0,  1 ],
		[  2,  0,  0,  0,  0,  0,  0,  0,  0,  0,  0,  1 ],
		[  1,  0,  0,  2,  2,  2,  0,  0,  0,  0,  0,  0 ],
		[  1,  0,  2,  2,  2,  2,  2,  0,  0,  0,  0,  0 ],
		[  1,  0,  2,  2,  5,  2,  2,  0,  0,  0,  0, 14 ],
		[  1,  1,  0,  1,  9,  1,  0,  1,  0,  1,  0,  1 ],
		[  0,  0,  1,  0,  1,  0,  1,  0,  1,  0,  1,  0 ]
	]
}