{
	"par": 22,
	"start": [ 0, 4 ],
	"grid": [
		[  0,  1,  0,  0,  0,  1,  1,  1 ],
		[  1,  0,  0,  0,  0,  1,  0,  0 ],
		[  0, 14,  0,  0,  0,  1,  0,  0 ],
		[  0,  1,  0,  0,  0,  0,  1,  0 ],
		[  1,  1,  0,  0,  0,  0,  1,  0 ],
		[  1,  1,  0,  0,  0,  2,  2,  0 ],
		[  0,  1,  0,  0,  0,  2,  0,  0 ],
		[  0,  0,  0,  0,  0,  2,  0,  2 ],
		[  1,  1,  0,  0,  0,  0,  2,  0 ]
	]
}