{
	"par": 37,
	"start": [ 6, 10 ],
	"grid": [
		[  0,  2,  0,  0,  0,  0,  0 ],
		[  2,  0,  2,  0,  0,  2,  0 ],
		[  2,  0,  2,  0,  2,  0,  2 ],
		[  2, 15,  2, 15,  6,  2,  2 ],
		[  1,  0, 15,  0,  0,  0,  2 ],
		[  1,  0,  2,  0,  0,  1,  2 ],
		[  1,  1,  0,  1,  0,  1,  0 ],
		[  0,  0,  1,  2,  1,  0,  0 ],
		[  0,  0,  2,  2,  2,  2,  0 ],
		[  0,  0,  0,  2, 16, 15,  0 ],
		[  0,  0,  0,  0,  2,  0,  1 ]
	]
}