{
	"par": 46,
	"start": [ 0, 4 ],
	"grid": [
		[  0,  0,  0,  0,  0,  0,  0,  1,  2,  0 ],
		[  0,  0,  0,  0,  0,  0,  4,  0,  0,  0 ],
		[  0,  0,  0, 12, 12,  0,  0,  0,  0,  0 ],
		[  1, 12, 12,  0,  0,  0,  0,  0,  0,  0 ],
		[  1,  0,  0, 12,  0,  0,  0,  2,  0,  0 ],
		[  0,  0,  0,  0,  0, 12,  0,  2,  2,  2 ],
		[  0,  0,  0,  0,  0,  0,  0, 12,  2,  2 ],
		[  0,  0,  0,  0,  0,  0,  0,  0,  2,  0 ]
	]
}