{
	"par": 121,
	"start": [ 5, 6 ],
	"grid": [
		[  0,  0,  0,  0,  0,  7,  0,  5,  2,  2,  0 ],
		[  0,  0,  0,  0, 37,  2,  0,  0,  0,  0, 10 ],
		[  0,  0,  0,  0,  2,  0,  2,  2,  2, 10, 10 ],
		[  0,  2,  2,  2,  2,  0,  2, 10, 10, 37,  0 ],
		[  0,  2,  2,  0, 34,  2,  2,  2,  2,  0,  0 ],
		[ 39,  2,  2,  2,  2,  2,  2, 41,  0,  0, 10 ],
		[  2,  0,  2, 41,  2,  2,  2,  0,  0,  0, 10 ],
		[  2,  0,  0,  2,  2,  2,  2, 37,  0,  2, 10 ],
		[  2,  5,  2,  2,  0,  0,  2,  2,  2,  0,  0 ],
		[  0,  2,  0,  2,  0,  0,  0,  0,  0,  0,  0 ],
		[  0,  0,  2, 39,  0,  0,  0,  0,  0,  0,  0 ]
	]
}